ID,Name,Male,Female,Delta,Link,poster,genre
2,The Shawshank Redemption,1,3,-2,https://www.imdb.com/title/tt0111161/,https://m.media-amazon.com/images/M/MV5BNDE3ODcxYzMtY2YzZC00NmNlLWJiNDMtZDViZWM2MzIxZDYwXkEyXkFqcGdeQXVyNjAwNDUxODI@._V1_.jpg,Drama
3,The Godfather,3,7,-4,https://www.imdb.com/title/tt0068646/,https://m.media-amazon.com/images/M/MV5BM2MyNjYxNmUtYTAwNi00MTYxLWJmNWYtYzZlODY3ZTk3OTFlXkEyXkFqcGdeQXVyNzkwMjQ5NzM@._V1_.jpg,"Crime, Drama"
4,The Dark Knight,5,17,-12,https://www.imdb.com/title/tt0468569/,https://m.media-amazon.com/images/M/MV5BMTMxNTMwODM0NF5BMl5BanBnXkFtZTcwODAyMTk2Mw@@._V1_.jpg,"Action, Crime, Drama"
5,The Godfather: Part II,4,14,-10,https://www.imdb.com/title/tt0071562/,https://m.media-amazon.com/images/M/MV5BMWMwMGQzZTItY2JlNC00OWZiLWIyMDctNDk2ZDQ2YjRjMWQ0XkEyXkFqcGdeQXVyNzkwMjQ5NzM@._V1_.jpg,"Crime, Drama"
6,12 Angry Men,8,10,-2,https://www.imdb.com/title/tt0050083/,https://m.media-amazon.com/images/M/MV5BMWU4N2FjNzYtNTVkNC00NzQ0LTg0MjAtYTJlMjFhNGUxZDFmXkEyXkFqcGdeQXVyNjc1NTYyMjg@._V1_.jpg,"Crime, Drama"
7,The Lord of the Rings: The Return of the King,7,8,-1,https://www.imdb.com/title/tt0167260/,https://m.media-amazon.com/images/M/MV5BNzA5ZDNlZWMtM2NhNS00NDJjLTk4NDItYTRmY2EwMWZlMTY3XkEyXkFqcGdeQXVyNzkwMjQ5NzM@._V1_.jpg,"Action, Adventure, Drama"
8,Pulp Fiction,6,38,-32,https://www.imdb.com/title/tt0110912/,https://m.media-amazon.com/images/M/MV5BNGNhMDIzZTUtNTBlZi00MTRlLWFjM2ItYzViMjE3YzI5MjljXkEyXkFqcGdeQXVyNzkwMjQ5NzM@._V1_.jpg,"Crime, Drama"
9,Schindler's List,9,5,4,https://www.imdb.com/title/tt0108052/,https://m.media-amazon.com/images/M/MV5BNDE4OTMxMTctNmRhYy00NWE2LTg3YzItYTk3M2UwOTU5Njg4XkEyXkFqcGdeQXVyNjU0OTQ0OTY@._V1_.jpg,"Biography, Drama, History"
10,The Mountain II,13,6,7,https://www.imdb.com/title/tt5813916/,https://m.media-amazon.com/images/M/MV5BN2I2NGMzMTItNWI4YS00MWRiLTliZTEtNzhjODE3NDcyZjQwXkEyXkFqcGdeQXVyMTMxODk2OTU@._V1_.jpg,"Action, Drama, War"
11,Inception,14,24,-10,https://www.imdb.com/title/tt1375666/,https://m.media-amazon.com/images/M/MV5BMjAxMzY3NjcxNF5BMl5BanBnXkFtZTcwNTI5OTM0Mw@@._V1_.jpg,"Action, Adventure, Sci-Fi"
12,Fight Club,11,19,-8,https://www.imdb.com/title/tt0137523/,https://m.media-amazon.com/images/M/MV5BMmEzNTkxYjQtZTc0MC00YTVjLTg5ZTEtZWMwOWVlYzY0NWIwXkEyXkFqcGdeQXVyNzkwMjQ5NzM@._V1_.jpg,Drama
13,The Lord of the Rings: The Fellowship of the Ring,12,12,0,https://www.imdb.com/title/tt0120737/,https://m.media-amazon.com/images/M/MV5BN2EyZjM3NzUtNWUzMi00MTgxLWI0NTctMzY4M2VlOTdjZWRiXkEyXkFqcGdeQXVyNDUzOTQ5MjY@._V1_.jpg,"Action, Adventure, Drama"
14,Forrest Gump,15,18,-3,https://www.imdb.com/title/tt0109830/,https://m.media-amazon.com/images/M/MV5BNWIwODRlZTUtY2U3ZS00Yzg1LWJhNzYtMmZiYmEyNmU1NjMzXkEyXkFqcGdeQXVyMTQxNzMzNDI@._V1_.jpg,"Drama, Romance"
15,"The Good, the Bad and the Ugly",10,76,-66,https://www.imdb.com/title/tt0060196/,https://m.media-amazon.com/images/M/MV5BNjJlYmNkZGItM2NhYy00MjlmLTk5NmQtNjg1NmM2ODU4OTMwXkEyXkFqcGdeQXVyMjUzOTY1NTc@._V1_.jpg,"Adventure, Drama, Western"
16,The Lord of the Rings: The Two Towers,17,20,-3,https://www.imdb.com/title/tt0167261/,https://m.media-amazon.com/images/M/MV5BZGMxZTdjZmYtMmE2Ni00ZTdkLWI5NTgtNjlmMjBiNzU2MmI5XkEyXkFqcGdeQXVyNjU0OTQ0OTY@._V1_.jpg,"Action, Adventure, Drama"
17,The Matrix,18,113,-95,https://www.imdb.com/title/tt0133093/,https://m.media-amazon.com/images/M/MV5BNzQzOTk3OTAtNDQ0Zi00ZTVkLWI0MTEtMDllZjNkYzNjNTc4L2ltYWdlXkEyXkFqcGdeQXVyNjU0OTQ0OTY@._V1_.jpg,"Action, Sci-Fi"
18,Goodfellas,21,102,-81,https://www.imdb.com/title/tt0099685/,https://m.media-amazon.com/images/M/MV5BY2NkZjEzMDgtN2RjYy00YzM1LWI4ZmQtMjIwYjFjNmI3ZGEwXkEyXkFqcGdeQXVyNzkwMjQ5NzM@._V1_.jpg,"Biography, Crime, Drama"
19,Star Wars: Episode V - The Empire Strikes Back,16,57,-41,https://www.imdb.com/title/tt0080684/,https://m.media-amazon.com/images/M/MV5BYmU1NDRjNDgtMzhiMi00NjZmLTg5NGItZDNiZjU5NTU4OTE0XkEyXkFqcGdeQXVyNzkwMjQ5NzM@._V1_.jpg,"Action, Adventure, Fantasy"
20,One Flew Over the Cuckoo's Nest,20,28,-8,https://www.imdb.com/title/tt0073486/,https://m.media-amazon.com/images/M/MV5BZjA0OWVhOTAtYWQxNi00YzNhLWI4ZjYtNjFjZTEyYjJlNDVlL2ltYWdlL2ltYWdlXkEyXkFqcGdeQXVyMTQxNzMzNDI@._V1_.jpg,Drama
21,Parasite,46,37,9,https://www.imdb.com/title/tt6751668/,https://m.media-amazon.com/images/M/MV5BYWZjMjk3ZTItODQ2ZC00NTY5LWE0ZDYtZTI3MjcwN2Q5NTVkXkEyXkFqcGdeQXVyODk4OTc3MTY@._V1_.jpg,"Drama, Thriller"
23,Interstellar,25,79,-54,https://www.imdb.com/title/tt0816692/,https://m.media-amazon.com/images/M/MV5BZjdkOTU3MDktN2IxOS00OGEyLWFmMjktY2FiMmZkNWIyODZiXkEyXkFqcGdeQXVyMTMxODk2OTU@._V1_.jpg,"Adventure, Drama, Sci-Fi"
24,City of God,23,71,-48,https://www.imdb.com/title/tt0317248/,https://m.media-amazon.com/images/M/MV5BMGU5OWEwZDItNmNkMC00NzZmLTk1YTctNzVhZTJjM2NlZTVmXkEyXkFqcGdeQXVyMTMxODk2OTU@._V1_.jpg,"Crime, Drama"
25,Spirited Away,43,13,30,https://www.imdb.com/title/tt0245429/,https://m.media-amazon.com/images/M/MV5BMjlmZmI5MDctNDE2YS00YWE0LWE5ZWItZDBhYWQ0NTcxNWRhXkEyXkFqcGdeQXVyMTMxODk2OTU@._V1_.jpg,"Animation, Adventure, Family"
26,Saving Private Ryan,28,282,-254,https://www.imdb.com/title/tt0120815/,https://m.media-amazon.com/images/M/MV5BZjhkMDM4MWItZTVjOC00ZDRhLThmYTAtM2I5NzBmNmNlMzI1XkEyXkFqcGdeQXVyNDYyMDk5MTU@._V1_.jpg,"Drama, War"
27,The Green Mile,42,21,21,https://www.imdb.com/title/tt0120689/,https://m.media-amazon.com/images/M/MV5BMTUxMzQyNjA5MF5BMl5BanBnXkFtZTYwOTU2NTY3._V1_.jpg,"Crime, Drama, Fantasy"
28,Life Is Beautiful,36,9,27,https://www.imdb.com/title/tt0118799/,https://m.media-amazon.com/images/M/MV5BYmJmM2Q4NmMtYThmNC00ZjRlLWEyZmItZTIwOTBlZDQ3NTQ1XkEyXkFqcGdeQXVyMTQxNzMzNDI@._V1_.jpg,"Comedy, Drama, Romance"
29,Se7en,22,44,-22,https://www.imdb.com/title/tt0114369/,https://m.media-amazon.com/images/M/MV5BOTUwODM5MTctZjczMi00OTk4LTg3NWUtNmVhMTAzNTNjYjcyXkEyXkFqcGdeQXVyNjU0OTQ0OTY@._V1_.jpg,"Crime, Drama, Mystery"
30,The Silence of the Lambs,30,33,-3,https://www.imdb.com/title/tt0102926/,https://m.media-amazon.com/images/M/MV5BNjNhZTk0ZmEtNjJhMi00YzFlLWE1MmEtYzM1M2ZmMGMwMTU4XkEyXkFqcGdeQXVyNjU0OTQ0OTY@._V1_.jpg,"Crime, Drama, Thriller"
31,Star Wars: Episode IV - A New Hope,26,58,-32,https://www.imdb.com/title/tt0076759/,https://m.media-amazon.com/images/M/MV5BOTA5NjhiOTAtZWM0ZC00MWNhLThiMzEtZDFkOTk2OTU1ZDJkXkEyXkFqcGdeQXVyMTA4NDI1NTQx._V1_.jpg,"Action, Adventure, Fantasy"
33,Seven Samurai,19,109,-90,https://www.imdb.com/title/tt0047478/,https://m.media-amazon.com/images/M/MV5BMTAzY2Q4OGUtMzg4Ni00YTBlLThkMDgtMTVlMjY0ZGRlMzdjXkEyXkFqcGdeQXVyMjQwMDg0Ng@@._V1_.jpg,"Action, Drama"
34,It's a Wonderful Life,24,32,-8,https://www.imdb.com/title/tt0038650/,https://m.media-amazon.com/images/M/MV5BZjc4NDZhZWMtNGEzYS00ZWU2LThlM2ItNTA0YzQ0OTExMTE2XkEyXkFqcGdeQXVyNjUwMzI2NzU@._V1_.jpg,"Drama, Family, Fantasy"
37,Whiplash,52,97,-45,https://www.imdb.com/title/tt2582802/,https://m.media-amazon.com/images/M/MV5BOTA5NDZlZGUtMjAxOS00YTRkLTkwYmMtYWQ0NWEwZDZiNjEzXkEyXkFqcGdeQXVyMTMxODk2OTU@._V1_.jpg,"Drama, Music"
38,The Intouchables,49,15,34,https://www.imdb.com/title/tt1675434/,https://m.media-amazon.com/images/M/MV5BMTYxNDA3MDQwNl5BMl5BanBnXkFtZTcwNTU4Mzc1Nw@@._V1_.jpg,"Comedy, Drama"
39,The Prestige,40,84,-44,https://www.imdb.com/title/tt0482571/,https://m.media-amazon.com/images/M/MV5BMTM3MzQ5MjQ5OF5BMl5BanBnXkFtZTcwMTQ3NzMzMw@@._V1_.jpg,"Drama, Mystery, Sci-Fi"
40,The Departed,47,105,-58,https://www.imdb.com/title/tt0407887/,https://m.media-amazon.com/images/M/MV5BMTI1MTY2OTIxNV5BMl5BanBnXkFtZTYwNjQ4NjY3._V1_.jpg,"Crime, Drama, Thriller"
41,The Pianist,50,23,27,https://www.imdb.com/title/tt0253474/,https://m.media-amazon.com/images/M/MV5BOWRiZDIxZjktMTA1NC00MDQ2LWEzMjUtMTliZmY3NjQ3ODJiXkEyXkFqcGdeQXVyNjU0OTQ0OTY@._V1_.jpg,"Biography, Drama, Music"
42,Gladiator,33,139,-106,https://www.imdb.com/title/tt0172495/,https://m.media-amazon.com/images/M/MV5BMDliMmNhNDEtODUyOS00MjNlLTgxODEtN2U3NzIxMGVkZTA1L2ltYWdlXkEyXkFqcGdeQXVyNjU0OTQ0OTY@._V1_.jpg,"Action, Adventure, Drama"
43,American History X,53,29,24,https://www.imdb.com/title/tt0120586/,https://m.media-amazon.com/images/M/MV5BZTJhN2FkYWEtMGI0My00YWM4LWI2MjAtM2UwNjY4MTI2ZTQyXkEyXkFqcGdeQXVyNjc3MjQzNTI@._V1_.jpg,"Crime, Drama"
44,The Usual Suspects,32,68,-36,https://www.imdb.com/title/tt0114814/,https://m.media-amazon.com/images/M/MV5BYTViNjMyNmUtNDFkNC00ZDRlLThmMDUtZDU2YWE4NGI2ZjVmXkEyXkFqcGdeQXVyNjU0OTQ0OTY@._V1_.jpg,"Crime, Drama, Mystery"
45,Léon: The Professional,34,25,9,https://www.imdb.com/title/tt0110413/,https://m.media-amazon.com/images/M/MV5BOTgyMWQ0ZWUtN2Q2MS00NmY0LWI3OWMtNjFkMzZlNDZjNTk0XkEyXkFqcGdeQXVyMjUzOTY1NTc@._V1_.jpg,"Action, Crime, Drama"
46,The Lion King,69,11,58,https://www.imdb.com/title/tt0110357/,https://m.media-amazon.com/images/M/MV5BYTYxNGMyZTYtMjE3MS00MzNjLWFjNmYtMDk3N2FmM2JiM2M1XkEyXkFqcGdeQXVyNjY5NDU4NzI@._V1_.jpg,"Animation, Adventure, Drama"
47,Terminator 2: Judgment Day,31,317,-286,https://www.imdb.com/title/tt0103064/,https://m.media-amazon.com/images/M/MV5BMGU2NzRmZjUtOGUxYS00ZjdjLWEwZWItY2NlM2JhNjkxNTFmXkEyXkFqcGdeQXVyNjU0OTQ0OTY@._V1_.jpg,"Action, Adventure, Sci-Fi"
48,Cinema Paradiso,58,36,22,https://www.imdb.com/title/tt0095765/,https://m.media-amazon.com/images/M/MV5BM2FhYjEyYmYtMDI1Yy00YTdlLWI2NWQtYmEzNzAxOGY1NjY2XkEyXkFqcGdeQXVyNTA3NTIyNDg@._V1_.jpg,"Drama, Romance"
49,Grave of the Fireflies,59,26,33,https://www.imdb.com/title/tt0095327/,https://m.media-amazon.com/images/M/MV5BZmY2NjUzNDQtNTgxNC00M2Q4LTljOWQtMjNjNDBjNWUxNmJlXkEyXkFqcGdeQXVyNTA4NzY1MzY@._V1_.jpg,"Animation, Drama, War"
50,Back to the Future,35,85,-50,https://www.imdb.com/title/tt0088763/,https://m.media-amazon.com/images/M/MV5BZmU0M2Y1OGUtZjIxNi00ZjBkLTg1MjgtOWIyNThiZWIwYjRiXkEyXkFqcGdeQXVyMTQxNzMzNDI@._V1_.jpg,"Adventure, Comedy, Sci-Fi"
51,Once Upon a Time in the West,48,299,-251,https://www.imdb.com/title/tt0064116/,https://m.media-amazon.com/images/M/MV5BODQ3NDExOGYtMzI3Mi00NWRlLTkwNjAtNjc4MDgzZGJiZTA1XkEyXkFqcGdeQXVyMjUzOTY1NTc@._V1_.jpg,"Drama, Western"
52,Psycho,41,59,-18,https://www.imdb.com/title/tt0054215/,https://m.media-amazon.com/images/M/MV5BNTQwNDM1YzItNDAxZC00NWY2LTk0M2UtNDIwNWI5OGUyNWUxXkEyXkFqcGdeQXVyNzkwMjQ5NzM@._V1_.jpg,"Horror, Mystery, Thriller"
53,Casablanca,38,95,-57,https://www.imdb.com/title/tt0034583/,https://m.media-amazon.com/images/M/MV5BY2IzZGY2YmEtYzljNS00NTM5LTgwMzUtMzM1NjQ4NGI0OTk0XkEyXkFqcGdeQXVyNDYyMDk5MTU@._V1_.jpg,"Drama, Romance, War"
54,Modern Times,37,51,-14,https://www.imdb.com/title/tt0027977/,https://m.media-amazon.com/images/M/MV5BM2VlMjY3N2UtN2ZjNC00MDg4LWI3ZGQtZmE4NjZkZjkwZmYzXkEyXkFqcGdeQXVyMTU3NDU4MDg2._V1_.jpg,"Comedy, Drama, Romance"
55,City Lights,39,43,-4,https://www.imdb.com/title/tt0021749/,https://m.media-amazon.com/images/M/MV5BY2I4MmM1N2EtM2YzOS00OWUzLTkzYzctNDc5NDg2N2IyODJmXkEyXkFqcGdeQXVyNzkwMjQ5NzM@._V1_.jpg,"Comedy, Drama, Romance"
57,Joker,73,50,23,https://www.imdb.com/title/tt7286456/,https://m.media-amazon.com/images/M/MV5BNGVjNWI4ZGUtNzE0MS00YTJmLWE0ZDctN2ZiYTk2YmI3NTYyXkEyXkFqcGdeQXVyMTkxNjUyNQ@@._V1_.jpg,"Crime, Drama, Thriller"
60,Your Name.,79,92,-13,https://www.imdb.com/title/tt5311514/,https://m.media-amazon.com/images/M/MV5BODRmZDVmNzUtZDA4ZC00NjhkLWI2M2UtN2M0ZDIzNDcxYThjL2ltYWdlXkEyXkFqcGdeQXVyNTk0MzMzODA@._V1_.jpg,"Animation, Drama, Fantasy"
61,Dangal,81,56,25,https://www.imdb.com/title/tt5074352/,https://m.media-amazon.com/images/M/MV5BMTQ4MzQzMzM2Nl5BMl5BanBnXkFtZTgwMTQ1NzU3MDI@._V1_.jpg,"Action, Biography, Drama"
62,Spider-Man: Into the Spider-Verse,112,49,63,https://www.imdb.com/title/tt4633694/,https://m.media-amazon.com/images/M/MV5BMjMwNDkxMTgzOF5BMl5BanBnXkFtZTgwNTkwNTQ3NjM@._V1_.jpg,"Animation, Action, Adventure"
63,Avengers: Endgame,110,41,69,https://www.imdb.com/title/tt4154796/,https://m.media-amazon.com/images/M/MV5BMTc5MDE2ODcwNV5BMl5BanBnXkFtZTgwMzI2NzQ2NzM@._V1_.jpg,"Action, Adventure, Drama"
64,Avengers: Infinity War,68,78,-10,https://www.imdb.com/title/tt4154756/,https://m.media-amazon.com/images/M/MV5BMjMxNjY2MDU1OV5BMl5BanBnXkFtZTgwNzY1MTUwNTM@._V1_.jpg,"Action, Adventure, Sci-Fi"
66,Coco,106,31,75,https://www.imdb.com/title/tt2380307/,https://m.media-amazon.com/images/M/MV5BYjQ5NjM0Y2YtNjZkNC00ZDhkLWJjMWItN2QyNzFkMDE3ZjAxXkEyXkFqcGdeQXVyODIxMzk5NjA@._V1_.jpg,"Animation, Adventure, Drama"
67,Django Unchained,55,90,-35,https://www.imdb.com/title/tt1853728/,https://m.media-amazon.com/images/M/MV5BMjIyNTQ5NjQ1OV5BMl5BanBnXkFtZTcwODg1MDU4OA@@._V1_.jpg,"Comedy, Drama, Western"
68,The Dark Knight Rises,64,91,-27,https://www.imdb.com/title/tt1345836/,https://m.media-amazon.com/images/M/MV5BMTk4ODQzNDY3Ml5BMl5BanBnXkFtZTcwODA0NTM4Nw@@._V1_.jpg,"Action, Drama, Thriller"
69,3 Idiots,78,104,-26,https://www.imdb.com/title/tt1187043/,https://m.media-amazon.com/images/M/MV5BNTkyOGVjMGEtNmQzZi00NzFlLTlhOWQtODYyMDc2ZGJmYzFhXkEyXkFqcGdeQXVyNjU0OTQ0OTY@._V1_.jpg,"Comedy, Drama"
70,Like Stars on Earth,77,119,-42,https://www.imdb.com/title/tt0986264/,https://m.media-amazon.com/images/M/MV5BMDhjZWViN2MtNzgxOS00NmI4LThiZDQtZDI3MzM4MDE4NTc0XkEyXkFqcGdeQXVyMTMxODk2OTU@._V1_.jpg,"Drama, Family"
71,WALL·E,70,67,3,https://www.imdb.com/title/tt0910970/,https://m.media-amazon.com/images/M/MV5BMjExMTg5OTU0NF5BMl5BanBnXkFtZTcwMjMxMzMzMw@@._V1_.jpg,"Animation, Adventure, Family"
72,The Lives of Others,67,34,33,https://www.imdb.com/title/tt0405094/,https://m.media-amazon.com/images/M/MV5BNmQyNmJjM2ItNTQzYi00ZjMxLWFjMDYtZjUyN2YwZDk5YWQ2XkEyXkFqcGdeQXVyMjUzOTY1NTc@._V1_.jpg,"Drama, Mystery, Thriller"
73,Oldboy,74,134,-60,https://www.imdb.com/title/tt0364569/,https://m.media-amazon.com/images/M/MV5BMTI3NTQyMzU5M15BMl5BanBnXkFtZTcwMTM2MjgyMQ@@._V1_.jpg,"Action, Drama, Mystery"
74,Memento,51,173,-122,https://www.imdb.com/title/tt0209144/,https://m.media-amazon.com/images/M/MV5BZTcyNjk1MjgtOWI3Mi00YzQwLWI5MTktMzY4ZmI2NDAyNzYzXkEyXkFqcGdeQXVyNjU0OTQ0OTY@._V1_.jpg,"Mystery, Thriller"
75,Princess Mononoke,75,99,-24,https://www.imdb.com/title/tt0119698/,https://m.media-amazon.com/images/M/MV5BNjM3NGExNDctYmU0Yy00MTJjLThlNTItMjM4NDBjMGRiMmE5XkEyXkFqcGdeQXVyMTUzMDUzNTI3._V1_.jpg,"Animation, Action, Adventure"
76,Once Upon a Time in America,85,223,-138,https://www.imdb.com/title/tt0087843/,https://m.media-amazon.com/images/M/MV5BMmQzZjdmZDAtOGE2Yy00MmUwLTljYzgtZTMwMjk3ZDdiOWUyXkEyXkFqcGdeQXVyNjc5NjEzNA@@._V1_.jpg,"Crime, Drama"
77,Indiana Jones and the Raiders of the Lost Ark,56,198,-142,https://www.imdb.com/title/tt0082971/,https://m.media-amazon.com/images/M/MV5BNTU2ODkyY2MtMjU1NC00NjE1LWEzYjgtMWQ3MzRhMTE0NDc0XkEyXkFqcGdeQXVyMjM4MzQ4OTQ@._V1_.jpg,"Action, Adventure"
78,The Shining,65,129,-64,https://www.imdb.com/title/tt0081505/,https://m.media-amazon.com/images/M/MV5BZWFlYmY2MGEtZjVkYS00YzU4LTg0YjQtYzY1ZGE3NTA5NGQxXkEyXkFqcGdeQXVyMTQxNzMzNDI@._V1_.jpg,"Drama, Horror"
79,Apocalypse Now,54,225,-171,https://www.imdb.com/title/tt0078788/,https://m.media-amazon.com/images/M/MV5BYmQyNTA1ZGItNjZjMi00NzFlLWEzMWEtNWMwN2Q2MjJhYzEyXkEyXkFqcGdeQXVyMjUzOTY1NTc@._V1_.jpg,"Drama, Mystery, War"
80,Alien,45,164,-119,https://www.imdb.com/title/tt0078748/,https://m.media-amazon.com/images/M/MV5BOGQzZTBjMjQtOTVmMS00NGE5LWEyYmMtOGQ1ZGZjNmRkYjFhXkEyXkFqcGdeQXVyMjUzOTY1NTc@._V1_.jpg,"Horror, Sci-Fi"
82,Dr. Strangelove or: How I Learned to Stop Worrying and Love the Bomb,66,272,-206,https://www.imdb.com/title/tt0057012/,https://m.media-amazon.com/images/M/MV5BZWI3ZTMxNjctMjdlNS00NmUwLWFiM2YtZDUyY2I3N2MxYTE0XkEyXkFqcGdeQXVyNzkwMjQ5NzM@._V1_.jpg,"Comedy, War"
83,Witness for the Prosecution,63,52,11,https://www.imdb.com/title/tt0051201/,https://m.media-amazon.com/images/M/MV5BNDQwODU5OWYtNDcyNi00MDQ1LThiOGMtZDkwNWJiM2Y3MDg0XkEyXkFqcGdeQXVyMDI2NDg0NQ@@._V1_.jpg,"Crime, Drama, Mystery"
84,Paths of Glory,61,245,-184,https://www.imdb.com/title/tt0050825/,https://m.media-amazon.com/images/M/MV5BOTI5Nzc0OTMtYzBkMS00NjkxLThmM2UtNjM2ODgxN2M5NjNkXkEyXkFqcGdeQXVyNjQ2MjQ5NzM@._V1_.jpg,"Drama, War"
85,Rear Window,57,48,9,https://www.imdb.com/title/tt0047396/,https://m.media-amazon.com/images/M/MV5BNGUxYWM3M2MtMGM3Mi00ZmRiLWE0NGQtZjE5ODI2OTJhNTU0XkEyXkFqcGdeQXVyMTQxNzMzNDI@._V1_.jpg,"Mystery, Thriller"
86,Sunset Blvd.,76,61,15,https://www.imdb.com/title/tt0043014/,https://m.media-amazon.com/images/M/MV5BMTU0NTkyNzYwMF5BMl5BanBnXkFtZTgwMDU0NDk5MTI@._V1_.jpg,"Drama, Film-Noir"
87,The Great Dictator,60,42,18,https://www.imdb.com/title/tt0032553/,https://m.media-amazon.com/images/M/MV5BMjc4ZjEwNDUtMjlmZS00NzQ4LTg2N2MtMGI3ZjMyMmM3ZDM2XkEyXkFqcGc@._V1_.jpg,"Comedy, Drama, War"
88,1917,128,122,6,https://www.imdb.com/title/tt8579674/,https://m.media-amazon.com/images/M/MV5BOTdmNTFjNDEtNzg0My00ZjkxLTg1ZDAtZTdkMDc2ZmFiNWQ1XkEyXkFqcGdeQXVyNTAzNzgwNTg@._V1_.jpg,"Action, Drama, History"
90,The Hunt,124,152,-28,https://www.imdb.com/title/tt2106476/,https://m.media-amazon.com/images/M/MV5BMTg2NDg3ODg4NF5BMl5BanBnXkFtZTcwNzk3NTc3Nw@@._V1_.jpg,Drama
91,A Separation,94,197,-103,https://www.imdb.com/title/tt1832382/,https://m.media-amazon.com/images/M/MV5BN2JmMjViMjMtZTM5Mi00ZGZkLTk5YzctZDg5MjFjZDE4NjNkXkEyXkFqcGdeQXVyMTMxODk2OTU@._V1_.jpg,Drama
92,Incendies,137,73,64,https://www.imdb.com/title/tt1255953/,https://m.media-amazon.com/images/M/MV5BMWE3MGYzZjktY2Q5Mi00Y2NiLWIyYWUtMmIyNzA3YmZlMGFhXkEyXkFqcGdeQXVyMTMxODk2OTU@._V1_.jpg,"Drama, Mystery, War"
96,Inglourious Basterds,107,101,6,https://www.imdb.com/title/tt0361748/,https://m.media-amazon.com/images/M/MV5BOTJiNDEzOWYtMTVjOC00ZjlmLWE0NGMtZmE1OWVmZDQ2OWJhXkEyXkFqcGdeQXVyNTIzOTk5ODM@._V1_.jpg,"Adventure, Drama, War"
97,Eternal Sunshine of the Spotless Mind,122,106,16,https://www.imdb.com/title/tt0338013/,https://m.media-amazon.com/images/M/MV5BMTY4NzcwODg3Nl5BMl5BanBnXkFtZTcwNTEwOTMyMw@@._V1_.jpg,"Drama, Romance, Sci-Fi"
98,Amélie,131,53,78,https://www.imdb.com/title/tt0211915/,https://m.media-amazon.com/images/M/MV5BNDg4NjM1YjMtYmNhZC00MjM0LWFiZmYtNGY1YjA3MzZmODc5XkEyXkFqcGdeQXVyNDk3NzU2MTQ@._V1_.jpg,"Comedy, Romance"
99,Snatch,90,318,-228,https://www.imdb.com/title/tt0208092/,https://m.media-amazon.com/images/M/MV5BMTA2NDYxOGYtYjU1Mi00Y2QzLTgxMTQtMWI1MGI0ZGQ5MmU4XkEyXkFqcGdeQXVyNDk3NzU2MTQ@._V1_.jpg,"Comedy, Crime"
100,Requiem for a Dream,118,108,10,https://www.imdb.com/title/tt0180093/,https://m.media-amazon.com/images/M/MV5BOTdiNzJlOWUtNWMwNS00NmFlLWI0YTEtZmI3YjIzZWUyY2Y3XkEyXkFqcGdeQXVyNjU0OTQ0OTY@._V1_.jpg,Drama
101,American Beauty,71,268,-197,https://www.imdb.com/title/tt0169547/,https://m.media-amazon.com/images/M/MV5BNTBmZWJkNjctNDhiNC00MGE2LWEwOTctZTk5OGVhMWMyNmVhXkEyXkFqcGdeQXVyMTMxODk2OTU@._V1_.jpg,Drama
102,Good Will Hunting,100,174,-74,https://www.imdb.com/title/tt0119217/,https://m.media-amazon.com/images/M/MV5BOTI0MzcxMTYtZDVkMy00NjY1LTgyMTYtZmUxN2M3NmQ2NWJhXkEyXkFqcGdeQXVyMTQxNzMzNDI@._V1_.jpg,"Drama, Romance"
104,Toy Story,80,169,-89,https://www.imdb.com/title/tt0114709/,https://m.media-amazon.com/images/M/MV5BMDU2ZWJlMjktMTRhMy00ZTA5LWEzNDgtYmNmZTEwZTViZWJkXkEyXkFqcGdeQXVyNDQ2OTk4MzI@._V1_.jpg,"Animation, Adventure, Comedy"
105,Braveheart,87,400,-313,https://www.imdb.com/title/tt0112573/,https://m.media-amazon.com/images/M/MV5BMzkzMmU0YTYtOWM3My00YzBmLWI0YzctOGYyNTkwMWE5MTJkXkEyXkFqcGdeQXVyNzkwMjQ5NzM@._V1_.jpg,"Biography, Drama, War"
106,Reservoir Dogs,97,257,-160,https://www.imdb.com/title/tt0105236/,https://m.media-amazon.com/images/M/MV5BZmExNmEwYWItYmQzOS00YjA5LTk2MjktZjEyZDE1Y2QxNjA1XkEyXkFqcGdeQXVyMTQxNzMzNDI@._V1_.jpg,"Crime, Thriller"
107,Full Metal Jacket,114,295,-181,https://www.imdb.com/title/tt0093058/,https://m.media-amazon.com/images/M/MV5BNzkxODk0NjEtYjc4Mi00ZDI0LTgyYjEtYzc1NDkxY2YzYTgyXkEyXkFqcGdeQXVyNzkwMjQ5NzM@._V1_.jpg,"Drama, War"
109,Aliens,72,258,-186,https://www.imdb.com/title/tt0090605/,https://m.media-amazon.com/images/M/MV5BOGJkY2EyOWYtYWRmNy00ZTEzLTllMDAtYzYzYjA0ZjFhZWJjXkEyXkFqcGdeQXVyMTUzMDUzNTI3._V1_.jpg,"Action, Adventure, Sci-Fi"
110,Amadeus,84,103,-19,https://www.imdb.com/title/tt0086879/,https://m.media-amazon.com/images/M/MV5BNWJlNzUzNGMtYTAwMS00ZjI2LWFmNWQtODcxNWUxODA5YmU1XkEyXkFqcGdeQXVyNTIzOTk5ODM@._V1_.jpg,"Biography, Drama, Music"
111,Scarface,105,411,-306,https://www.imdb.com/title/tt0086250/,https://m.media-amazon.com/images/M/MV5BNjdjNGQ4NDEtNTEwYS00MTgxLTliYzQtYzE2ZDRiZjFhZmNlXkEyXkFqcGdeQXVyNjU0OTQ0OTY@._V1_.jpg,"Crime, Drama"
112,Star Wars: Episode VI - Return of the Jedi,83,110,-27,https://www.imdb.com/title/tt0086190/,https://m.media-amazon.com/images/M/MV5BOWZlMjFiYzgtMTUzNC00Y2IzLTk1NTMtZmNhMTczNTk0ODk1XkEyXkFqcGdeQXVyNTAyODkwOQ@@._V1_.jpg,"Action, Adventure, Fantasy"
113,Das Boot,86,354,-268,https://www.imdb.com/title/tt0082096/,https://m.media-amazon.com/images/M/MV5BNDBjMWUxNTUtNjZiNi00YzJhLTgzNzUtMTRiY2FkZmMzYTNjXkEyXkFqcGdeQXVyMTUzMDUzNTI3._V1_.jpg,"Drama, War"
114,The Sting,103,208,-105,https://www.imdb.com/title/tt0070735/,https://m.media-amazon.com/images/M/MV5BNGU3NjQ4YTMtZGJjOS00YTQ3LThmNmItMTI5MDE2ODI3NzY3XkEyXkFqcGdeQXVyMjUzOTY1NTc@._V1_.jpg,"Comedy, Crime, Drama"
115,A Clockwork Orange,109,260,-151,https://www.imdb.com/title/tt0066921/,https://m.media-amazon.com/images/M/MV5BMTY3MjM1Mzc4N15BMl5BanBnXkFtZTgwODM0NzAxMDE@._V1_.jpg,"Crime, Sci-Fi"
117,2001: A Space Odyssey,82,479,-397,https://www.imdb.com/title/tt0062622/,https://m.media-amazon.com/images/M/MV5BMmNlYzRiNDctZWNhMi00MzI4LThkZTctMTUzMmZkMmFmNThmXkEyXkFqcGdeQXVyNzkwMjQ5NzM@._V1_.jpg,"Adventure, Sci-Fi"
118,Lawrence of Arabia,108,437,-329,https://www.imdb.com/title/tt0056172/,https://m.media-amazon.com/images/M/MV5BYWY5ZjhjNGYtZmI2Ny00ODM0LWFkNzgtZmI1YzA2N2MxMzA0XkEyXkFqcGdeQXVyNjUwNzk3NDc@._V1_.jpg,"Adventure, Biography, Drama"
119,The Apartment,98,251,-153,https://www.imdb.com/title/tt0053604/,https://m.media-amazon.com/images/M/MV5BNzkwODFjNzItMmMwNi00MTU5LWE2MzktM2M4ZDczZGM1MmViXkEyXkFqcGdeQXVyNDY2MTk1ODk@._V1_.jpg,"Comedy, Drama, Romance"
120,North by Northwest,115,184,-69,https://www.imdb.com/title/tt0053125/,https://m.media-amazon.com/images/M/MV5BZDA3NDExMTUtMDlhOC00MmQ5LWExZGUtYmI1NGVlZWI4OWNiXkEyXkFqcGdeQXVyNjc1NTYyMjg@._V1_.jpg,"Action, Adventure, Mystery"
121,Vertigo,92,162,-70,https://www.imdb.com/title/tt0052357/,https://m.media-amazon.com/images/M/MV5BYTE4ODEwZDUtNDFjOC00NjAxLWEzYTQtYTI1NGVmZmFlNjdiL2ltYWdlL2ltYWdlXkEyXkFqcGdeQXVyNjc1NTYyMjg@._V1_.jpg,"Mystery, Romance, Thriller"
122,Singin' in the Rain,145,45,100,https://www.imdb.com/title/tt0045152/,https://m.media-amazon.com/images/M/MV5BZDRjNGViMjQtOThlMi00MTA3LThkYzQtNzJkYjBkMGE0YzE1XkEyXkFqcGdeQXVyNDYyMDk5MTU@._V1_.jpg,"Comedy, Musical, Romance"
124,Bicycle Thieves,102,153,-51,https://www.imdb.com/title/tt0040522/,https://m.media-amazon.com/images/M/MV5BNWEwYTIwZDEtNDIwZi00ZmY1LTg1OGYtZDE5NWI2OGRmNmQzXkEyXkFqcGdeQXVyNDUzOTQ5MjY@._V1_.jpg,Drama
125,Double Indemnity,89,292,-203,https://www.imdb.com/title/tt0036775/,https://m.media-amazon.com/images/M/MV5BOTdlNjgyZGUtOTczYi00MDdhLTljZmMtYTEwZmRiOWFkYjRhXkEyXkFqcGdeQXVyNDY2MTk1ODk@._V1_.jpg,"Crime, Drama, Film-Noir"
126,Citizen Kane,111,335,-224,https://www.imdb.com/title/tt0033467/,https://m.media-amazon.com/images/M/MV5BYjBiOTYxZWItMzdiZi00NjlkLWIzZTYtYmFhZjhiMTljOTdkXkEyXkFqcGdeQXVyNzkwMjQ5NzM@._V1_.jpg,"Drama, Mystery"
127,M,91,123,-32,https://www.imdb.com/title/tt0022100/,https://m.media-amazon.com/images/M/MV5BODA4ODk3OTEzMF5BMl5BanBnXkFtZTgwMTQ2ODMwMzE@._V1_.jpg,"Crime, Mystery, Thriller"
128,Metropolis,132,124,8,https://www.imdb.com/title/tt0017136/,https://m.media-amazon.com/images/M/MV5BMTg5YWIyMWUtZDY5My00Zjc1LTljOTctYmI0MWRmY2M2NmRkXkEyXkFqcGdeQXVyMTMxODk2OTU@._V1_.jpg,"Drama, Sci-Fi"
129,The Kid,116,77,39,https://www.imdb.com/title/tt0012349/,https://m.media-amazon.com/images/M/MV5BZjhhMThhNDItNTY2MC00MmU1LTliNDEtNDdhZjdlNTY5ZDQ1XkEyXkFqcGdeQXVyNjc1NTYyMjg@._V1_.jpg,"Comedy, Drama, Family"
134,Green Book,175,89,86,https://www.imdb.com/title/tt6966692/,https://m.media-amazon.com/images/M/MV5BYzIzYmJlYTYtNGNiYy00N2EwLTk4ZjItMGYyZTJiOTVkM2RlXkEyXkFqcGdeQXVyODY1NDk1NjE@._V1_.jpg,"Biography, Comedy, Drama"
137,Klaus,298,62,236,https://www.imdb.com/title/tt4729430/,https://m.media-amazon.com/images/M/MV5BMWYwOThjM2ItZGYxNy00NTQwLWFlZWEtM2MzM2Q5MmY3NDU5XkEyXkFqcGdeQXVyMTkxNjUyNQ@@._V1_.jpg,"Animation, Adventure, Comedy"
146,The Secret in Their Eyes,152,176,-24,https://www.imdb.com/title/tt1305806/,https://m.media-amazon.com/images/M/MV5BMTgwNTI3OTczOV5BMl5BanBnXkFtZTcwMTM3MTUyMw@@._V1_.jpg,"Drama, Mystery, Romance"
147,Warrior,181,206,-25,https://www.imdb.com/title/tt1291584/,https://m.media-amazon.com/images/M/MV5BMTk4ODk5MTMyNV5BMl5BanBnXkFtZTcwMDMyNTg0Ng@@._V1_.jpg,"Action, Drama, Sport"
148,Shutter Island,176,196,-20,https://www.imdb.com/title/tt1130884/,https://m.media-amazon.com/images/M/MV5BYzhiNDkyNzktNTZmYS00ZTBkLTk2MDAtM2U0YjU1MzgxZjgzXkEyXkFqcGdeQXVyMTMxODk2OTU@._V1_.jpg,"Drama, Mystery, Thriller"
149,Up,151,69,82,https://www.imdb.com/title/tt1049413/,https://m.media-amazon.com/images/M/MV5BYjBkM2RjMzItM2M3Ni00N2NjLWE3NzMtMGY4MzE4MDAzMTRiXkEyXkFqcGdeQXVyNDUzOTQ5MjY@._V1_.jpg,"Animation, Adventure, Comedy"
151,The Wolf of Wall Street,125,656,-531,https://www.imdb.com/title/tt0993846/,https://m.media-amazon.com/images/M/MV5BMjIxMjgxNTk0MF5BMl5BanBnXkFtZTgwNjIyOTg2MDE@._V1_.jpg,"Biography, Comedy, Crime"
153,There Will Be Blood,216,626,-410,https://www.imdb.com/title/tt0469494/,https://m.media-amazon.com/images/M/MV5BMjAxODQ4MDU5NV5BMl5BanBnXkFtZTcwMDU4MjU1MQ@@._V1_.jpg,Drama
154,Pan's Labyrinth,167,133,34,https://www.imdb.com/title/tt0457430/,https://m.media-amazon.com/images/M/MV5BYzFjMThiMGItOWRlMC00MDI4LThmOGUtYTNlZGZiYWI1YjMyXkEyXkFqcGdeQXVyMjUzOTY1NTc@._V1_.jpg,"Drama, Fantasy, War"
155,Toy Story 3,96,148,-52,https://www.imdb.com/title/tt0435761/,https://m.media-amazon.com/images/M/MV5BMTgxOTY4Mjc0MF5BMl5BanBnXkFtZTcwNTA4MDQyMw@@._V1_.jpg,"Animation, Adventure, Comedy"
156,V for Vendetta,169,218,-49,https://www.imdb.com/title/tt0434409/,https://m.media-amazon.com/images/M/MV5BOTI5ODc3NzExNV5BMl5BanBnXkFtZTcwNzYxNzQzMw@@._V1_.jpg,"Action, Drama, Sci-Fi"
157,Rang De Basanti,182,1063,-881,https://www.imdb.com/title/tt0405508/,https://m.media-amazon.com/images/M/MV5BYThmZDA0YmQtMWJhNy00MDQwLTk0Y2YtMDhmZTE5ZjhlNjliXkEyXkFqcGdeQXVyODE5NzE3OTE@._V1_.jpg,"Comedy, Crime, Drama"
159,Batman Begins,120,372,-252,https://www.imdb.com/title/tt0372784/,https://m.media-amazon.com/images/M/MV5BOTY4YjI2N2MtYmFlMC00ZjcyLTg3YjEtMDQyM2ZjYzQ5YWFkXkEyXkFqcGdeQXVyMTQxNzMzNDI@._V1_.jpg,"Action, Crime, Drama"
161,Downfall,138,326,-188,https://www.imdb.com/title/tt0363163/,https://m.media-amazon.com/images/M/MV5BMTU0NTU5NTAyMl5BMl5BanBnXkFtZTYwNzYwMDg2._V1_.jpg,"Biography, Drama, History"
162,Howl's Moving Castle,318,27,291,https://www.imdb.com/title/tt0347149/,https://m.media-amazon.com/images/M/MV5BMTY1OTg0MjE3MV5BMl5BanBnXkFtZTcwNTUxMTkyMQ@@._V1_.jpg,"Animation, Adventure, Family"
163,A Beautiful Mind,154,150,4,https://www.imdb.com/title/tt0268978/,https://m.media-amazon.com/images/M/MV5BMzcwYWFkYzktZjAzNC00OGY1LWI4YTgtNzc5MzVjMDVmNjY0XkEyXkFqcGdeQXVyMTQxNzMzNDI@._V1_.jpg,"Biography, Drama, Mystery"
165,"Lock, Stock and Two Smoking Barrels",179,323,-144,https://www.imdb.com/title/tt0120735/,https://m.media-amazon.com/images/M/MV5BMTAyN2JmZmEtNjAyMy00NzYwLThmY2MtYWQ3OGNhNjExMmM4XkEyXkFqcGdeQXVyNDk3NzU2MTQ@._V1_.jpg,"Action, Comedy, Crime"
166,L.A. Confidential,119,460,-341,https://www.imdb.com/title/tt0119488/,https://m.media-amazon.com/images/M/MV5BMDQ2YzEyZGItYWRhOS00MjBmLTkzMDUtMTdjYzkyMmQxZTJlXkEyXkFqcGdeQXVyNjU0OTQ0OTY@._V1_.jpg,"Crime, Drama, Mystery"
168,Heat,126,648,-522,https://www.imdb.com/title/tt0113277/,https://m.media-amazon.com/images/M/MV5BYjZjNTJlZGUtZTE1Ny00ZDc4LTgwYjUtMzk0NDgwYzZjYTk1XkEyXkFqcGdeQXVyNjU0OTQ0OTY@._V1_.jpg,"Action, Crime, Drama"
169,Casino,160,569,-409,https://www.imdb.com/title/tt0112641/,https://m.media-amazon.com/images/M/MV5BMTcxOWYzNDYtYmM4YS00N2NkLTk0NTAtNjg1ODgwZjAxYzI3XkEyXkFqcGdeQXVyNTA4NzY1MzY@._V1_.jpg,"Crime, Drama"
171,Unforgiven,139,736,-597,https://www.imdb.com/title/tt0105695/,https://m.media-amazon.com/images/M/MV5BODM3YWY4NmQtN2Y3Ni00OTg0LWFhZGQtZWE3ZWY4MTJlOWU4XkEyXkFqcGdeQXVyNjU0OTQ0OTY@._V1_.jpg,"Drama, Western"
172,Indiana Jones and the Last Crusade,135,300,-165,https://www.imdb.com/title/tt0097576/,https://m.media-amazon.com/images/M/MV5BY2Q0ODg4ZmItNDZiYi00ZWY5LTg2NzctNmYwZjA5OThmNzE1XkEyXkFqcGdeQXVyMjM4MzQ4OTQ@._V1_.jpg,"Action, Adventure"
174,My Neighbor Totoro,239,66,173,https://www.imdb.com/title/tt0096283/,https://m.media-amazon.com/images/M/MV5BYzJjMTYyMjQtZDI0My00ZjE2LTkyNGYtOTllNGQxNDMyZjE0XkEyXkFqcGdeQXVyMTMxODk2OTU@._V1_.jpg,"Animation, Comedy, Family"
175,Die Hard,117,572,-455,https://www.imdb.com/title/tt0095016/,https://m.media-amazon.com/images/M/MV5BZjRlNDUxZjAtOGQ4OC00OTNlLTgxNmQtYTBmMDgwZmNmNjkxXkEyXkFqcGdeQXVyNzkwMjQ5NzM@._V1_.jpg,"Action, Thriller"
176,Ran,140,347,-207,https://www.imdb.com/title/tt0089881/,https://m.media-amazon.com/images/M/MV5BMmU1NGYwZWYtOWExNi00ZTEyLTgwMmUtM2ZlMDVjNWM4YjVlXkEyXkFqcGdeQXVyMjUzOTY1NTc@._V1_.jpg,"Action, Drama, War"
177,Raging Bull,147,833,-686,https://www.imdb.com/title/tt0081398/,https://m.media-amazon.com/images/M/MV5BYjRmODkzNDItMTNhNi00YjJlLTg0ZjAtODlhZTM0YzgzYThlXkEyXkFqcGdeQXVyNzQ1ODk3MTQ@._V1_.jpg,"Biography, Drama, Sport"
178,Stalker,225,151,74,https://www.imdb.com/title/tt0079944/,https://m.media-amazon.com/images/M/MV5BYTAzZmEzZjEtNmIzMS00MzlhLWE0Y2ItNDRlNTQwN2E0MDE4XkEyXkFqcGdeQXVyMzY0MTE3NzU@._V1_.jpg,"Drama, Sci-Fi"
180,Taxi Driver,101,378,-277,https://www.imdb.com/title/tt0075314/,https://m.media-amazon.com/images/M/MV5BM2M1MmVhNDgtNmI0YS00ZDNmLTkyNjctNTJiYTQ2N2NmYzc2XkEyXkFqcGdeQXVyNzkwMjQ5NzM@._V1_.jpg,"Crime, Drama"
183,Monty Python and the Holy Grail,144,199,-55,https://www.imdb.com/title/tt0071853/,https://m.media-amazon.com/images/M/MV5BN2IyNTE4YzUtZWU0Mi00MGIwLTgyMmQtMzQ4YzQxYWNlYWE2XkEyXkFqcGdeQXVyNjU0OTQ0OTY@._V1_.jpg,"Adventure, Comedy, Fantasy"
184,For a Few Dollars More,121,467,-346,https://www.imdb.com/title/tt0059578/,https://m.media-amazon.com/images/M/MV5BMzJlZTNkYjQtMTE1OS00YTJlLTgxNjItYzg4NTllODdkMzBiXkEyXkFqcGdeQXVyMjUzOTY1NTc@._V1_.jpg,"Drama, Western"
185,The Great Escape,142,312,-170,https://www.imdb.com/title/tt0057115/,https://m.media-amazon.com/images/M/MV5BNzA2NmYxMWUtNzBlMC00MWM2LTkwNmQtYTFlZjQwODNhOWE0XkEyXkFqcGdeQXVyNTIzOTk5ODM@._V1_.jpg,"Adventure, Drama, Thriller"
186,To Kill a Mockingbird,123,70,53,https://www.imdb.com/title/tt0056592/,https://m.media-amazon.com/images/M/MV5BNmVmYzcwNzMtMWM1NS00MWIyLThlMDEtYzUwZDgzODE1NmE2XkEyXkFqcGdeQXVyNzkwMjQ5NzM@._V1_.jpg,"Crime, Drama"
187,Yojimbo,113,507,-394,https://www.imdb.com/title/tt0055630/,https://m.media-amazon.com/images/M/MV5BZThiZjAzZjgtNDU3MC00YThhLThjYWUtZGRkYjc2ZWZlOTVjXkEyXkFqcGdeQXVyNTA4NzY1MzY@._V1_.jpg,"Action, Drama, Thriller"
189,Some Like It Hot,173,93,80,https://www.imdb.com/title/tt0053291/,https://m.media-amazon.com/images/M/MV5BNzAyOGIxYjAtMGY2NC00ZTgyLWIwMWEtYzY0OWQ4NDFjOTc5XkEyXkFqcGdeQXVyNjU0OTQ0OTY@._V1_.jpg,"Comedy, Music, Romance"
191,The Seventh Seal,219,221,-2,https://www.imdb.com/title/tt0050976/,https://m.media-amazon.com/images/M/MV5BOWM3MmE0OGYtOGVlNC00OWE1LTk5ZTAtYmUwMDIwM2ZlNWJiXkEyXkFqcGdeQXVyMjUzOTY1NTc@._V1_.jpg,"Drama, Fantasy"
192,Dial M for Murder,164,224,-60,https://www.imdb.com/title/tt0046912/,https://m.media-amazon.com/images/M/MV5BOWIwODIxYWItZDI4MS00YzhhLWE3MmYtMzlhZDIwOTMzZmE5L2ltYWdlXkEyXkFqcGdeQXVyNjc1NTYyMjg@._V1_.jpg,"Crime, Thriller"
194,Rashomon,146,276,-130,https://www.imdb.com/title/tt0042876/,https://m.media-amazon.com/images/M/MV5BMjEzMzA4NDE2OF5BMl5BanBnXkFtZTcwNTc5MDI2NQ@@._V1_.jpg,"Crime, Drama, Mystery"
195,All About Eve,162,46,116,https://www.imdb.com/title/tt0042192/,https://m.media-amazon.com/images/M/MV5BYmE1M2Y3NTYtYTI0Mi00N2JlLTkzMzItOTY1MTlhNWNkMDgzXkEyXkFqcGdeQXVyMTUzMDUzNTI3._V1_.jpg,Drama
196,The Treasure of the Sierra Madre,141,484,-343,https://www.imdb.com/title/tt0040897/,https://m.media-amazon.com/images/M/MV5BOTJlZWMxYzEtMjlkMS00ODE0LThlM2ItMDI3NGQ2YjhmMzkxXkEyXkFqcGdeQXVyMDI2NDg0NQ@@._V1_.jpg,"Adventure, Drama, Western"
198,The Gold Rush,190,279,-89,https://www.imdb.com/title/tt0015864/,https://m.media-amazon.com/images/M/MV5BMDA3NmE2OTYtZWQ1Zi00OGI2LTk5NjctNThhNGJjYTI1NzRlXkEyXkFqcGdeQXVyNjc5NjEzNA@@._V1_.jpg,"Adventure, Comedy, Drama"
203,"Three Billboards Outside Ebbing, Missouri",253,190,63,https://www.imdb.com/title/tt5027774/,https://m.media-amazon.com/images/M/MV5BMjI0ODcxNzM1N15BMl5BanBnXkFtZTgwMzIwMTEwNDI@._V1_.jpg,"Comedy, Crime, Drama"
204,The Invisible Guest,407,171,236,https://www.imdb.com/title/tt4857264/,https://m.media-amazon.com/images/M/MV5BOTEwYTkzMTMtODEzNC00YWM2LTgxNDMtZWNkNTQzNDVjMWQ2L2ltYWdlL2ltYWdlXkEyXkFqcGdeQXVyMDY4NTQ1MA@@._V1_.jpg,"Crime, Drama, Mystery"
205,The Handmaiden,281,185,96,https://www.imdb.com/title/tt4016934/,https://m.media-amazon.com/images/M/MV5BNDJhYTk2MTctZmVmOS00OTViLTgxNjQtMzQxOTRiMDdmNGRjXkEyXkFqcGdeQXVyMTMxODk2OTU@._V1_.jpg,"Drama, Romance, Thriller"
209,Logan,345,510,-165,https://www.imdb.com/title/tt3315342/,https://m.media-amazon.com/images/M/MV5BYzc5MTU4N2EtYTkyMi00NjdhLTg3NWEtMTY4OTEyMzJhZTAzXkEyXkFqcGdeQXVyNjc1NTYyMjg@._V1_.jpg,"Action, Drama, Sci-Fi"
210,Room,254,125,129,https://www.imdb.com/title/tt3170832/,https://m.media-amazon.com/images/M/MV5BMjE4NzgzNzEwMl5BMl5BanBnXkFtZTgwMTMzMDE0NjE@._V1_.jpg,"Drama, Thriller"
211,Wild Tales,214,157,57,https://www.imdb.com/title/tt3011894/,https://m.media-amazon.com/images/M/MV5BNzAzMjA1ODAxOV5BMl5BanBnXkFtZTgwODg4NTQzNDE@._V1_.jpg,"Comedy, Drama, Thriller"
212,Soul,400,192,208,https://www.imdb.com/title/tt2948372/,https://m.media-amazon.com/images/M/MV5BZGE1MDg5M2MtNTkyZS00MTY5LTg1YzUtZTlhZmM1Y2EwNmFmXkEyXkFqcGdeQXVyNjA3OTI0MDc@._V1_.jpg,"Animation, Adventure, Comedy"
215,PK,246,336,-90,https://www.imdb.com/title/tt2338151/,https://m.media-amazon.com/images/M/MV5BMTg5NzIzMzEyOF5BMl5BanBnXkFtZTgwMjgzMTg0MzE@._V1_.jpg,"Comedy, Drama, Sci-Fi"
217,The Grand Budapest Hotel,274,212,62,https://www.imdb.com/title/tt2278388/,https://m.media-amazon.com/images/M/MV5BMzM5NjUxOTEyMl5BMl5BanBnXkFtZTgwNjEyMDM0MDE@._V1_.jpg,"Adventure, Comedy, Crime"
218,Gone Girl,184,285,-101,https://www.imdb.com/title/tt2267998/,https://m.media-amazon.com/images/M/MV5BMTk0MDQ3MzAzOV5BMl5BanBnXkFtZTgwNzU1NzE3MjE@._V1_.jpg,"Drama, Mystery, Thriller"
221,Hacksaw Ridge,292,114,178,https://www.imdb.com/title/tt2119532/,https://m.media-amazon.com/images/M/MV5BMjQ1NjM3MTUxNV5BMl5BanBnXkFtZTgwMDc5MTY5OTE@._V1_.jpg,"Biography, Drama, History"
222,Inside Out,186,160,26,https://www.imdb.com/title/tt2096673/,https://m.media-amazon.com/images/M/MV5BOTgxMDQwMDk0OF5BMl5BanBnXkFtZTgwNjU5OTg2NDE@._V1_.jpg,"Animation, Adventure, Comedy"
224,12 Years a Slave,271,242,29,https://www.imdb.com/title/tt2024544/,https://m.media-amazon.com/images/M/MV5BMjExMTEzODkyN15BMl5BanBnXkFtZTcwNTU4NTc4OQ@@._V1_.jpg,"Biography, Drama, History"
225,Rush,215,341,-126,https://www.imdb.com/title/tt1979320/,https://m.media-amazon.com/images/M/MV5BOWEwODJmZDItYTNmZC00OGM4LThlNDktOTQzZjIzMGQxODA4XkEyXkFqcGdeQXVyNjU0OTQ0OTY@._V1_.jpg,"Action, Biography, Drama"
226,Ford v Ferrari,301,296,5,https://www.imdb.com/title/tt1950186/,https://m.media-amazon.com/images/M/MV5BM2UwMDVmMDItM2I2Yi00NGZmLTk4ZTUtY2JjNTQ3OGQ5ZjM2XkEyXkFqcGdeQXVyMTA1OTYzOTUx._V1_.jpg,"Action, Biography, Drama"
227,Spotlight,283,262,21,https://www.imdb.com/title/tt1895587/,https://m.media-amazon.com/images/M/MV5BMjIyOTM5OTIzNV5BMl5BanBnXkFtZTgwMDkzODE2NjE@._V1_.jpg,"Biography, Crime, Drama"
230,Prisoners,266,404,-138,https://www.imdb.com/title/tt1392214/,https://m.media-amazon.com/images/M/MV5BMTg0NTIzMjQ1NV5BMl5BanBnXkFtZTcwNDc3MzM5OQ@@._V1_.jpg,"Crime, Drama, Mystery"
231,Mad Max: Fury Road,237,564,-327,https://www.imdb.com/title/tt1392190/,https://m.media-amazon.com/images/M/MV5BN2EwM2I5OWMtMGQyMi00Zjg1LWJkNTctZTdjYTA4OGUwZjMyXkEyXkFqcGdeQXVyMTMxODk2OTU@._V1_.jpg,"Action, Adventure, Sci-Fi"
233,Zack Snyder's Justice League,279,387,-108,https://www.imdb.com/title/tt12361974/,https://m.media-amazon.com/images/M/MV5BYjI3NDg0ZTEtMDEwYS00YWMyLThjYjktMTNlM2NmYjc1OGRiXkEyXkFqcGdeQXVyMTEyMjM2NDc2._V1_.jpg,"Action, Adventure, Fantasy"
234,Gran Torino,227,246,-19,https://www.imdb.com/title/tt1205489/,https://m.media-amazon.com/images/M/MV5BMTc5NTk2OTU1Nl5BMl5BanBnXkFtZTcwMDc3NjAwMg@@._V1_.jpg,Drama
235,Harry Potter and the Deathly Hallows: Part 2,442,35,407,https://www.imdb.com/title/tt1201607/,https://m.media-amazon.com/images/M/MV5BMGVmMWNiMDktYjQ0Mi00MWIxLTk0N2UtN2ZlYTdkN2IzNDNlXkEyXkFqcGdeQXVyODE5NzE3OTE@._V1_.jpg,"Adventure, Family, Fantasy"
237,Hachi: A Dog's Tale,316,83,233,https://www.imdb.com/title/tt1028532/,https://m.media-amazon.com/images/M/MV5BYmQzYjgyYzEtOTVhZC00MDRkLWJjNjItYzU3N2RiMTExZjA1XkEyXkFqcGdeQXVyMTcwOTQzOTYy._V1_.jpg,"Biography, Drama, Family"
238,Mary and Max,310,74,236,https://www.imdb.com/title/tt0978762/,https://m.media-amazon.com/images/M/MV5BMDgzYjQwMDMtNGUzYi00MTRmLWIyMGMtNjE1OGZkNzY2YWIzL2ltYWdlXkEyXkFqcGdeQXVyNjU0OTQ0OTY@._V1_.jpg,"Animation, Comedy, Drama"
239,How to Train Your Dragon,355,63,292,https://www.imdb.com/title/tt0892769/,https://m.media-amazon.com/images/M/MV5BMjA5NDQyMjc2NF5BMl5BanBnXkFtZTcwMjg5ODcyMw@@._V1_.jpg,"Animation, Action, Adventure"
240,Into the Wild,262,264,-2,https://www.imdb.com/title/tt0758758/,https://m.media-amazon.com/images/M/MV5BNjQ0ODlhMWUtNmUwMS00YjExLWI4MjQtNjVmMmE2Y2E0MGRmXkEyXkFqcGdeQXVyNDk3NzU2MTQ@._V1_.jpg,"Adventure, Biography, Drama"
241,No Country for Old Men,208,799,-591,https://www.imdb.com/title/tt0477348/,https://m.media-amazon.com/images/M/MV5BMjA5Njk3MjM4OV5BMl5BanBnXkFtZTcwMTc5MTE1MQ@@._V1_.jpg,"Crime, Drama, Thriller"
244,Million Dollar Baby,230,343,-113,https://www.imdb.com/title/tt0405159/,https://m.media-amazon.com/images/M/MV5BMTkxNzA1NDQxOV5BMl5BanBnXkFtZTcwNTkyMTIzMw@@._V1_.jpg,"Drama, Sport"
245,Hotel Rwanda,297,175,122,https://www.imdb.com/title/tt0395169/,https://m.media-amazon.com/images/M/MV5BZGJjYmIzZmQtNWE4Yy00ZGVmLWJkZGEtMzUzNmQ4ZWFlMjRhXkEyXkFqcGdeQXVyMTMxODk2OTU@._V1_.jpg,"Biography, Drama, History"
247,Before Sunset,352,463,-111,https://www.imdb.com/title/tt0381681/,https://m.media-amazon.com/images/M/MV5BMTQ1MjAwNTM5Ml5BMl5BanBnXkFtZTYwNDM0MTc3._V1_.jpg,"Drama, Romance"
249,Memories of Murder,197,465,-268,https://www.imdb.com/title/tt0353969/,https://m.media-amazon.com/images/M/MV5BOGViNTg4YTktYTQ2Ni00MTU0LTk2NWUtMTI4OTc1YTM0NzQ2XkEyXkFqcGdeQXVyMDM2NDM2MQ@@._V1_.jpg,"Crime, Drama, Mystery"
251,Kill Bill: Vol. 1,250,293,-43,https://www.imdb.com/title/tt0266697/,https://m.media-amazon.com/images/M/MV5BNzM3NDFhYTAtYmU5Mi00NGRmLTljYjgtMDkyODQ4MjNkMGY2XkEyXkFqcGdeQXVyNzkwMjQ5NzM@._V1_.jpg,"Action, Crime, Thriller"
252,Finding Nemo,287,107,180,https://www.imdb.com/title/tt0266543/,https://m.media-amazon.com/images/M/MV5BYWE0MzUzNDctNTFiYS00YzY3LWEzYWMtMDQyMWE5OTMxOTBiXkEyXkFqcGdeQXVyNjAwNDUxODI@._V1_.jpg,"Animation, Adventure, Comedy"
253,Catch Me If You Can,317,305,12,https://www.imdb.com/title/tt0264464/,https://m.media-amazon.com/images/M/MV5BMTY5MzYzNjc5NV5BMl5BanBnXkFtZTYwNTUyNTc2._V1_.jpg,"Biography, Crime, Drama"
254,Amores Perros,260,291,-31,https://www.imdb.com/title/tt0245712/,https://m.media-amazon.com/images/M/MV5BZjUxNmEwOGItMTBmYi00MWQ1LWExY2MtNDUxMjI0OWM4M2NiXkEyXkFqcGdeQXVyMjUzOTY1NTc@._V1_.jpg,"Drama, Thriller"
255,"Monsters, Inc.",402,149,253,https://www.imdb.com/title/tt0198781/,https://m.media-amazon.com/images/M/MV5BMTY1NTI0ODUyOF5BMl5BanBnXkFtZTgwNTEyNjQ0MDE@._V1_.jpg,"Animation, Adventure, Comedy"
257,Lagaan: Once Upon a Time in India,280,827,-547,https://www.imdb.com/title/tt0169102/,https://m.media-amazon.com/images/M/MV5BNDYxNWUzZmYtOGQxMC00MTdkLTkxOTctYzkyOGIwNWQxZjhmXkEyXkFqcGdeQXVyNjU0OTQ0OTY@._V1_.jpg,"Drama, Musical, Sport"
258,The Sixth Sense,200,204,-4,https://www.imdb.com/title/tt0167404/,https://m.media-amazon.com/images/M/MV5BMWM4NTFhYjctNzUyNi00NGMwLTk3NTYtMDIyNTZmMzRlYmQyXkEyXkFqcGdeQXVyMTAwMzUyOTc@._V1_.jpg,"Drama, Mystery, Thriller"
260,The Truman Show,221,356,-135,https://www.imdb.com/title/tt0120382/,https://m.media-amazon.com/images/M/MV5BMDIzODcyY2EtMmY2MC00ZWVlLTgwMzAtMjQwOWUyNmJjNTYyXkEyXkFqcGdeQXVyNDk3NzU2MTQ@._V1_.jpg,"Comedy, Drama"
262,The Big Lebowski,174,733,-559,https://www.imdb.com/title/tt0118715/,https://m.media-amazon.com/images/M/MV5BMzliZDk0NjctNjhlOC00MWEyLWI3OWYtNjA5ZDYxMTMzNTc5XkEyXkFqcGdeQXVyNTAyODkwOQ@@._V1_.jpg,"Comedy, Crime"
263,In the Mood for Love,330,188,142,https://www.imdb.com/title/tt0118694/,https://m.media-amazon.com/images/M/MV5BYWVjNjMwZTgtMGYyYy00NmVhLWE1NDItMzFhMmJkYTNjYWIwXkEyXkFqcGdeQXVyNjU0OTQ0OTY@._V1_.jpg,"Drama, Romance"
264,Trainspotting,231,267,-36,https://www.imdb.com/title/tt0117951/,https://m.media-amazon.com/images/M/MV5BMzA5Zjc3ZTMtMmU5YS00YTMwLWI4MWUtYTU0YTVmNjVmODZhXkEyXkFqcGdeQXVyNjU0OTQ0OTY@._V1_.jpg,Drama
265,Fargo,195,408,-213,https://www.imdb.com/title/tt0116282/,https://m.media-amazon.com/images/M/MV5BNDJiZDgyZjctYmRjMS00ZjdkLTkwMTEtNGU1NDg3NDQ0Yzk1XkEyXkFqcGdeQXVyNzkwMjQ5NzM@._V1_.jpg,"Crime, Thriller"
267,La Haine,278,350,-72,https://www.imdb.com/title/tt0113247/,https://m.media-amazon.com/images/M/MV5BOTQxOGU0OWUtMzExYy00ZjIxLWJmMzAtNTI1Y2YxYTMxN2RkXkEyXkFqcGdeQXVyMjUzOTY1NTc@._V1_.jpg,"Crime, Drama"
269,Before Sunrise,249,309,-60,https://www.imdb.com/title/tt0112471/,https://m.media-amazon.com/images/M/MV5BZDdiZTAwYzAtMDI3Ni00OTRjLTkzN2UtMGE3MDMyZmU4NTU4XkEyXkFqcGdeQXVyNjU0OTQ0OTY@._V1_.jpg,"Drama, Romance"
272,Jurassic Park,205,431,-226,https://www.imdb.com/title/tt0107290/,https://m.media-amazon.com/images/M/MV5BMjM2MDgxMDg0Nl5BMl5BanBnXkFtZTgwNTM2OTM5NDE@._V1_.jpg,"Action, Adventure, Sci-Fi"
273,In the Name of the Father,252,210,42,https://www.imdb.com/title/tt0107207/,https://m.media-amazon.com/images/M/MV5BMmYyOTgwYWItYmU3Ny00M2E2LTk0NWMtMDVlNmQ0MWZiMTMxXkEyXkFqcGdeQXVyNzkwMjQ5NzM@._V1_.jpg,"Biography, Crime, Drama"
276,Dead Poets Society,408,130,278,https://www.imdb.com/title/tt0097165/,https://m.media-amazon.com/images/M/MV5BOGYwYWNjMzgtNGU4ZC00NWQ2LWEwZjUtMzE1Zjc3NjY3YTU1XkEyXkFqcGdeQXVyMTQxNzMzNDI@._V1_.jpg,"Comedy, Drama"
277,Stand by Me,366,145,221,https://www.imdb.com/title/tt0092005/,https://m.media-amazon.com/images/M/MV5BODJmY2Y2OGQtMDg2My00N2Q3LWJmZTUtYTc2ODBjZDVlNDlhXkEyXkFqcGdeQXVyMTQxNzMzNDI@._V1_.jpg,"Adventure, Comedy, Drama"
278,Platoon,259,619,-360,https://www.imdb.com/title/tt0091763/,https://m.media-amazon.com/images/M/MV5BMzRjZjdlMjQtODVkYS00N2YzLWJlYWYtMGVlN2E5MWEwMWQzXkEyXkFqcGdeQXVyMTQxNzMzNDI@._V1_.jpg,"Drama, War"
281,Nausicaä of the Valley of the Wind,270,287,-17,https://www.imdb.com/title/tt0087544/,https://m.media-amazon.com/images/M/MV5BZTI3NmJmYTQtNDg4NS00M2VlLTgzZDAtZWIwZDcyOWY5YzIzXkEyXkFqcGdeQXVyMTMxODk2OTU@._V1_.jpg,"Animation, Adventure, Sci-Fi"
282,The Thing,199,785,-586,https://www.imdb.com/title/tt0084787/,https://m.media-amazon.com/images/M/MV5BNGViZWZmM2EtNGYzZi00ZDAyLTk3ODMtNzIyZTBjN2Y1NmM1XkEyXkFqcGdeQXVyNTAyODkwOQ@@._V1_.jpg,"Horror, Mystery, Sci-Fi"
286,Blade Runner,155,643,-488,https://www.imdb.com/title/tt0083658/,https://m.media-amazon.com/images/M/MV5BNzQzMzJhZTEtOWM4NS00MTdhLTg0YjgtMjM4MDRkZjUwZDBlXkEyXkFqcGdeQXVyNjU0OTQ0OTY@._V1_.jpg,"Action, Drama, Sci-Fi"
287,The Elephant Man,202,159,43,https://www.imdb.com/title/tt0080678/,https://m.media-amazon.com/images/M/MV5BMDVjNjIwOGItNDE3Ny00OThjLWE0NzQtZTU3YjMzZTZjMzhkXkEyXkFqcGdeQXVyMTQxNzMzNDI@._V1_.jpg,"Biography, Drama"
288,Monty Python's Life of Brian,234,409,-175,https://www.imdb.com/title/tt0079470/,https://m.media-amazon.com/images/M/MV5BMDA1ZWI4ZDItOTRlYi00OTUxLWFlNWQtMzM5NDI0YjA4ZGI2XkEyXkFqcGdeQXVyMjUzOTY1NTc@._V1_.jpg,Comedy
289,The Deer Hunter,198,294,-96,https://www.imdb.com/title/tt0077416/,https://m.media-amazon.com/images/M/MV5BNDhmNTA0ZDMtYjhkNS00NzEzLWIzYTItOGNkMTVmYjE2YmI3XkEyXkFqcGdeQXVyNzkwMjQ5NzM@._V1_.jpg,"Drama, War"
290,Rocky,261,1073,-812,https://www.imdb.com/title/tt0075148/,https://m.media-amazon.com/images/M/MV5BNTBkMjg2MjYtYTZjOS00ODQ0LTg0MDEtM2FiNmJmOGU1NGEwXkEyXkFqcGdeQXVyMjUzOTY1NTc@._V1_.jpg,"Drama, Sport"
291,Network,251,480,-229,https://www.imdb.com/title/tt0074958/,https://m.media-amazon.com/images/M/MV5BNzY0NjU5ODUtOTAzMC00NTU5LWJkZjctYWMyOWY2MTZmOWM1XkEyXkFqcGdeQXVyMTI3ODAyMzE2._V1_.jpg,Drama
292,Barry Lyndon,228,888,-660,https://www.imdb.com/title/tt0072684/,https://m.media-amazon.com/images/M/MV5BNmY0MWY2NDctZDdmMi00MjA1LTk0ZTQtZDMyZTQ1NTNlYzVjXkEyXkFqcGdeQXVyMjUzOTY1NTc@._V1_.jpg,"Adventure, Drama, War"
294,Chinatown,196,527,-331,https://www.imdb.com/title/tt0071315/,https://m.media-amazon.com/images/M/MV5BMjJkMDZhYzItZTFhMi00ZGI4LThlNTAtZDNlYmEwNjFkNDYzXkEyXkFqcGdeQXVyMjUzOTY1NTc@._V1_.jpg,"Drama, Mystery, Thriller"
299,Cool Hand Luke,206,421,-215,https://www.imdb.com/title/tt0061512/,https://m.media-amazon.com/images/M/MV5BNjcwNTQ3Y2EtMjdmZi00ODBhLWFhNzQtOTc3MWU5NTZlMDViXkEyXkFqcGdeQXVyMjUzOTY1NTc@._V1_.jpg,"Crime, Drama"
300,Persona,302,186,116,https://www.imdb.com/title/tt0060827/,https://m.media-amazon.com/images/M/MV5BYmFlOTcxMWUtZTMzMi00NWIyLTkwOTEtNjIxNmViNzc2Yzc1XkEyXkFqcGdeQXVyMjUzOTY1NTc@._V1_.jpg,"Drama, Thriller"
310,The 400 Blows,305,273,32,https://www.imdb.com/title/tt0053198/,https://m.media-amazon.com/images/M/MV5BYTQ4MjA4NmYtYjRhNi00MTEwLTg0NjgtNjk3ODJlZGU4NjRkL2ltYWdlL2ltYWdlXkEyXkFqcGdeQXVyNjU0OTQ0OTY@._V1_.jpg,"Crime, Drama"
311,Ben-Hur,210,578,-368,https://www.imdb.com/title/tt0052618/,https://m.media-amazon.com/images/M/MV5BNjgxY2JiZDYtZmMwOC00ZmJjLWJmODUtMTNmNWNmYWI5ODkwL2ltYWdlL2ltYWdlXkEyXkFqcGdeQXVyNjc1NTYyMjg@._V1_.jpg,"Adventure, Drama"
315,The Bridge on the River Kwai,189,447,-258,https://www.imdb.com/title/tt0050212/,https://m.media-amazon.com/images/M/MV5BOGY5NmNlMmQtYzRlYy00NGQ5LWFkYjYtNzExZmQyMTg0ZDA0XkEyXkFqcGdeQXVyNDIzMzcwNjc@._V1_.jpg,"Adventure, Drama, War"
317,On the Waterfront,193,320,-127,https://www.imdb.com/title/tt0047296/,https://m.media-amazon.com/images/M/MV5BY2I0MWFiZDMtNWQyYy00Njk5LTk3MDktZjZjNTNmZmVkYjkxXkEyXkFqcGdeQXVyNjc1NTYyMjg@._V1_.jpg,"Crime, Drama, Thriller"
321,The Third Man,177,314,-137,https://www.imdb.com/title/tt0041959/,https://m.media-amazon.com/images/M/MV5BYjE2OTdhMWUtOGJlMy00ZDViLWIzZjgtYjZkZGZmMDZjYmEyXkEyXkFqcGdeQXVyNzkwMjQ5NzM@._V1_.jpg,"Film-Noir, Mystery, Thriller"
324,Rebecca,327,131,196,https://www.imdb.com/title/tt0032976/,https://m.media-amazon.com/images/M/MV5BOGVmYmZiYTItNjUyNy00NzE4LTlhYjctMWEwMzYxYzEyMjNiXkEyXkFqcGc@._V1_.jpg,"Drama, Mystery, Romance"
325,Mr. Smith Goes to Washington,209,222,-13,https://www.imdb.com/title/tt0031679/,https://m.media-amazon.com/images/M/MV5BZTYwYjYxYzgtMDE1Ni00NzU4LWJlMTEtODQ5YmJmMGJhZjI5L2ltYWdlXkEyXkFqcGdeQXVyMDI2NDg0NQ@@._V1_.jpg,"Comedy, Drama"
326,Gone with the Wind,324,39,285,https://www.imdb.com/title/tt0031381/,https://m.media-amazon.com/images/M/MV5BYjUyZWZkM2UtMzYxYy00ZmQ3LWFmZTQtOGE2YjBkNjA3YWZlXkEyXkFqcGdeQXVyNzkwMjQ5NzM@._V1_.jpg,"Drama, Romance, War"
339,La La Land,339,694,-355,https://www.imdb.com/title/tt3783958/,https://m.media-amazon.com/images/M/MV5BMzUzNDM2NzM2MV5BMl5BanBnXkFtZTgwNTM3NTg4OTE@._V1_.jpg,"Comedy, Drama, Music"
340,Lion,463,116,347,https://www.imdb.com/title/tt3741834/,https://m.media-amazon.com/images/M/MV5BMjA3NjkzNjg2MF5BMl5BanBnXkFtZTgwMDkyMzgzMDI@._V1_.jpg,"Biography, Drama"
341,The Martian,421,407,14,https://www.imdb.com/title/tt3659388/,https://m.media-amazon.com/images/M/MV5BMTc2MTQ3MDA1Nl5BMl5BanBnXkFtZTgwODA3OTI4NjE@._V1_.jpg,"Adventure, Drama, Sci-Fi"
342,Zootopia,433,191,242,https://www.imdb.com/title/tt2948356/,https://m.media-amazon.com/images/M/MV5BOTMyMjEyNzIzMV5BMl5BanBnXkFtZTgwNzIyNjU0NzE@._V1_.jpg,"Animation, Action, Adventure"
343,Baahubali: The Beginning,429,853,-424,https://www.imdb.com/title/tt2631186/,https://m.media-amazon.com/images/M/MV5BYWVlMjVhZWYtNWViNC00ODFkLTk1MmItYjU1MDY5ZDdhMTU3XkEyXkFqcGdeQXVyODIwMDI1NjM@._V1_.jpg,"Action, Drama"
345,Wonder,560,229,331,https://www.imdb.com/title/tt2543472/,https://m.media-amazon.com/images/M/MV5BYjFhOWY0OTgtNDkzMC00YWJkLTk1NGEtYWUxNjhmMmQ5ZjYyXkEyXkFqcGdeQXVyMjMxOTE0ODA@._V1_.jpg,"Drama, Family"
349,The Raid 2,445,828,-383,https://www.imdb.com/title/tt2265171/,https://m.media-amazon.com/images/M/MV5BZWExZWQ0ZmItM2VmZC00YjBhLTk2MzctNWRiNzhmZTEwNmYwXkEyXkFqcGdeQXVyMTA4NjE0NjEy._V1_.jpg,"Action, Crime, Thriller"
350,The Imitation Game,416,118,298,https://www.imdb.com/title/tt2084970/,https://m.media-amazon.com/images/M/MV5BNjI3NjY1Mjg3MV5BMl5BanBnXkFtZTgwMzk5MDQ3MjE@._V1_.jpg,"Biography, Drama, Thriller"
351,Guardians of the Galaxy,338,328,10,https://www.imdb.com/title/tt2015381/,https://m.media-amazon.com/images/M/MV5BNDIzMTk4NDYtMjg5OS00ZGI0LWJhZDYtMzdmZGY1YWU5ZGNkXkEyXkFqcGdeQXVyMTI5NzUyMTIz._V1_.jpg,"Action, Adventure, Comedy"
352,Blade Runner 2049,393,978,-585,https://www.imdb.com/title/tt1856101/,https://m.media-amazon.com/images/M/MV5BNzA1Njg4NzYxOV5BMl5BanBnXkFtZTgwODk5NjU3MzI@._V1_.jpg,"Action, Drama, Mystery"
353,Her,311,800,-489,https://www.imdb.com/title/tt1798709/,https://m.media-amazon.com/images/M/MV5BMjA1Nzk0OTM2OF5BMl5BanBnXkFtZTgwNjU2NjEwMDE@._V1_.jpg,"Drama, Romance, Sci-Fi"
354,Bohemian Rhapsody,607,75,532,https://www.imdb.com/title/tt1727824/,https://m.media-amazon.com/images/M/MV5BMTA2NDc3Njg5NDVeQTJeQWpwZ15BbWU4MDc1NDcxNTUz._V1_.jpg,"Biography, Drama, Music"
355,The Revenant,387,723,-336,https://www.imdb.com/title/tt1663202/,https://m.media-amazon.com/images/M/MV5BMDE5OWMzM2QtOTU2ZS00NzAyLWI2MDEtOTRlYjIxZGM0OWRjXkEyXkFqcGdeQXVyODE5NzE3OTE@._V1_.jpg,"Action, Adventure, Drama"
356,The Perks of Being a Wallflower,499,339,160,https://www.imdb.com/title/tt1659337/,https://m.media-amazon.com/images/M/MV5BZThjMmQ5YjktMTUyMC00MjljLWJmMTAtOWIzNDIzY2VhNzQ0XkEyXkFqcGdeQXVyMTAyNjg4NjE0._V1_.jpg,Drama
358,The King's Speech,464,168,296,https://www.imdb.com/title/tt1504320/,https://m.media-amazon.com/images/M/MV5BMzU5MjEwMTg2Nl5BMl5BanBnXkFtZTcwNzM3MTYxNA@@._V1_.jpg,"Biography, Drama, History"
359,The Help,487,82,405,https://www.imdb.com/title/tt1454029/,https://m.media-amazon.com/images/M/MV5BMTM5OTMyMjIxOV5BMl5BanBnXkFtZTcwNzU4MjIwNQ@@._V1_.jpg,Drama
360,Deadpool,424,416,8,https://www.imdb.com/title/tt1431045/,https://m.media-amazon.com/images/M/MV5BYzE5MjY1ZDgtMTkyNC00MTMyLThhMjAtZGI5OTE1NzFlZGJjXkEyXkFqcGdeQXVyNjU0OTQ0OTY@._V1_.jpg,"Action, Comedy"
363,Yip Man,361,545,-184,https://www.imdb.com/title/tt1220719/,https://m.media-amazon.com/images/M/MV5BNTFmMjM3M2UtOTIyZC00Zjk3LTkzODUtYTdhNGRmNzFhYzcyXkEyXkFqcGdeQXVyMTMxODk2OTU@._V1_.jpg,"Action, Biography, Drama"
366,Slumdog Millionaire,385,286,99,https://www.imdb.com/title/tt1010048/,https://m.media-amazon.com/images/M/MV5BZmNjZWI3NzktYWI1Mi00OTAyLWJkNTYtMzUwYTFlZDA0Y2UwXkEyXkFqcGdeQXVyNjU0OTQ0OTY@._V1_.jpg,"Crime, Drama, Romance"
367,Black Swan,419,410,9,https://www.imdb.com/title/tt0947798/,https://m.media-amazon.com/images/M/MV5BNzY2NzI4OTE5MF5BMl5BanBnXkFtZTcwMjMyNDY4Mw@@._V1_.jpg,"Drama, Thriller"
369,The Avengers,383,220,163,https://www.imdb.com/title/tt0848228/,https://m.media-amazon.com/images/M/MV5BNDYxNjQyMjAtNTdiOS00NGYwLWFmNTAtNThmYjU5ZGI2YTI1XkEyXkFqcGdeQXVyMTMxODk2OTU@._V1_.jpg,"Action, Sci-Fi"
371,Dallas Buyers Club,437,349,88,https://www.imdb.com/title/tt0790636/,https://m.media-amazon.com/images/M/MV5BMTYwMTA4MzgyNF5BMl5BanBnXkFtZTgwMjEyMjE0MDE@._V1_.jpg,"Biography, Drama"
372,The Pursuit of Happyness,451,450,1,https://www.imdb.com/title/tt0454921/,https://m.media-amazon.com/images/M/MV5BMTQ5NjQ0NDI3NF5BMl5BanBnXkFtZTcwNDI0MjEzMw@@._V1_.jpg,"Biography, Drama"
373,Blood Diamond,364,389,-25,https://www.imdb.com/title/tt0450259/,https://m.media-amazon.com/images/M/MV5BZDMxOGZhNWYtMzRlYy00Mzk5LWJjMjEtNmQ4NDU4M2QxM2UzXkEyXkFqcGdeQXVyNTA4NzY1MzY@._V1_.jpg,"Adventure, Drama, Thriller"
374,The Bourne Ultimatum,359,610,-251,https://www.imdb.com/title/tt0440963/,https://m.media-amazon.com/images/M/MV5BNGNiNmU2YTMtZmU4OS00MjM0LTlmYWUtMjVlYjAzYjE2N2RjXkEyXkFqcGdeQXVyNDk3NzU2MTQ@._V1_.jpg,"Action, Mystery, Thriller"
376,Sin City,328,956,-628,https://www.imdb.com/title/tt0401792/,https://m.media-amazon.com/images/M/MV5BMDc2YmZiOTctNWJkNi00NTc4LThmMjctYjhlMGE1NDdkN2RlXkEyXkFqcGdeQXVyNjkwOTQ4MDE@._V1_.jpg,"Crime, Thriller"
377,The Diving Bell and the Butterfly,395,310,85,https://www.imdb.com/title/tt0401383/,https://m.media-amazon.com/images/M/MV5BMTc3MjkzMDkxN15BMl5BanBnXkFtZTcwODAyMTU1MQ@@._V1_.jpg,"Biography, Drama"
379,Ratatouille,363,357,6,https://www.imdb.com/title/tt0382932/,https://m.media-amazon.com/images/M/MV5BMTMzODU0NTkxMF5BMl5BanBnXkFtZTcwMjQ4MzMzMw@@._V1_.jpg,"Animation, Adventure, Comedy"
380,Casino Royale,443,885,-442,https://www.imdb.com/title/tt0381061/,https://m.media-amazon.com/images/M/MV5BMTM5MjI4NDExNF5BMl5BanBnXkFtZTcwMDM1MjMzMQ@@._V1_.jpg,"Action, Adventure, Thriller"
381,Kill Bill: Vol. 2,461,355,106,https://www.imdb.com/title/tt0378194/,https://m.media-amazon.com/images/M/MV5BNmFiYmJmN2QtNWQwMi00MzliLThiOWMtZjQxNGRhZTQ1MjgyXkEyXkFqcGdeQXVyNzQ1ODk3MTQ@._V1_.jpg,"Action, Crime, Thriller"
385,Cinderella Man,371,573,-202,https://www.imdb.com/title/tt0352248/,https://m.media-amazon.com/images/M/MV5BNTkyMmZmNTYtMTE3MS00NmZlLWIyOGQtZGU2Y2YyMjBlZmI0XkEyXkFqcGdeQXVyMTUzMDUzNTI3._V1_.jpg,"Biography, Drama, Romance"
386,Infernal Affairs,314,394,-80,https://www.imdb.com/title/tt0338564/,https://m.media-amazon.com/images/M/MV5BODMzOGVmZDktMGNjNS00NzJkLWJiZGUtNTU1YTIyMzI4Njc4XkEyXkFqcGdeQXVyNDgyODgxNjE@._V1_.jpg,"Action, Crime, Drama"
387,Pirates of the Caribbean: The Curse of the Black Pearl,423,214,209,https://www.imdb.com/title/tt0325980/,https://m.media-amazon.com/images/M/MV5BNGYyZGM5MGMtYTY2Ni00M2Y1LWIzNjQtYWUzM2VlNGVhMDNhXkEyXkFqcGdeQXVyMTMxODk2OTU@._V1_.jpg,"Action, Adventure, Fantasy"
388,Big Fish,450,284,166,https://www.imdb.com/title/tt0319061/,https://m.media-amazon.com/images/M/MV5BZTNlNTQzMGEtYjU4Yi00MzEzLThmMTQtNmM0NzcxZWI1MTk0XkEyXkFqcGdeQXVyMjUzOTY1NTc@._V1_.jpg,"Adventure, Drama, Fantasy"
389,The Incredibles,388,678,-290,https://www.imdb.com/title/tt0317705/,https://m.media-amazon.com/images/M/MV5BMTY5OTU0OTc2NV5BMl5BanBnXkFtZTcwMzU4MDcyMQ@@._V1_.jpg,"Animation, Action, Adventure"
391,Dogville,444,234,210,https://www.imdb.com/title/tt0276919/,https://m.media-amazon.com/images/M/MV5BMTkwNTg2MTI1NF5BMl5BanBnXkFtZTcwMDM1MzUyMQ@@._V1_.jpg,"Crime, Drama"
393,Donnie Darko,358,353,5,https://www.imdb.com/title/tt0246578/,https://m.media-amazon.com/images/M/MV5BZjZlZDlkYTktMmU1My00ZDBiLWFlNjEtYTBhNjVhOTM4ZjJjXkEyXkFqcGdeQXVyMTMxODk2OTU@._V1_.jpg,"Drama, Mystery, Sci-Fi"
394,Magnolia,372,855,-483,https://www.imdb.com/title/tt0175880/,https://m.media-amazon.com/images/M/MV5BZjk3YThkNDktNjZjMS00MTBiLTllNTAtYzkzMTU0N2QwYjJjXkEyXkFqcGdeQXVyMTMxODk2OTU@._V1_.jpg,Drama
395,Dancer in the Dark,489,346,143,https://www.imdb.com/title/tt0168629/,https://m.media-amazon.com/images/M/MV5BNDVkYWMxNWEtNjc2MC00OGI5LWI3NmUtYWUwNDQyOTc3YmY5XkEyXkFqcGdeQXVyMTQxNzMzNDI@._V1_.jpg,"Crime, Drama, Musical"
400,The Iron Giant,389,414,-25,https://www.imdb.com/title/tt0129167/,https://m.media-amazon.com/images/M/MV5BYzBjZTNkMzQtZmNkOC00Yzk0LTljMjktZjk3YWVlZjY3NTk2XkEyXkFqcGdeQXVyMTUzMDUzNTI3._V1_.jpg,"Animation, Action, Adventure"
404,12 Monkeys,300,547,-247,https://www.imdb.com/title/tt0114746/,https://m.media-amazon.com/images/M/MV5BN2Y2OWU4MWMtNmIyMy00YzMyLWI0Y2ItMTcyZDc3MTdmZDU4XkEyXkFqcGdeQXVyMTQxNzMzNDI@._V1_.jpg,"Mystery, Sci-Fi, Thriller"
405,Ghost in the Shell,405,712,-307,https://www.imdb.com/title/tt0113568/,https://m.media-amazon.com/images/M/MV5BYWRiYjQyOGItNzQ1Mi00MGI1LWE3NjItNTg1ZDQwNjUwNDM2XkEyXkFqcGdeQXVyNTAyODkwOQ@@._V1_.jpg,"Animation, Action, Crime"
406,The Nightmare Before Christmas,522,140,382,https://www.imdb.com/title/tt0107688/,https://m.media-amazon.com/images/M/MV5BNWE4OTNiM2ItMjY4Ni00ZTViLWFiZmEtZGEyNGY2ZmNlMzIyXkEyXkFqcGdeQXVyMDU5NDcxNw@@._V1_.jpg,"Animation, Family, Fantasy"
407,Groundhog Day,236,1029,-793,https://www.imdb.com/title/tt0107048/,https://m.media-amazon.com/images/M/MV5BZWIxNzM5YzQtY2FmMS00Yjc3LWI1ZjUtNGVjMjMzZTIxZTIxXkEyXkFqcGdeQXVyNjU0OTQ0OTY@._V1_.jpg,"Comedy, Drama, Fantasy"
409,Scent of a Woman,384,383,1,https://www.imdb.com/title/tt0105323/,https://m.media-amazon.com/images/M/MV5BZTM3ZjA3NTctZThkYy00ODYyLTk2ZjItZmE0MmZlMTk3YjQwXkEyXkFqcGdeQXVyNTA4NzY1MzY@._V1_.jpg,Drama
410,Aladdin,418,177,241,https://www.imdb.com/title/tt0103639/,https://m.media-amazon.com/images/M/MV5BZTg5ZTVmM2EtZjdhZC00MzBjLWEwZTYtNWIwZDczYzZkMzA4XkEyXkFqcGdeQXVyMTQxNzMzNDI@._V1_.jpg,"Animation, Adventure, Comedy"
411,JFK,340,741,-401,https://www.imdb.com/title/tt0102138/,https://m.media-amazon.com/images/M/MV5BYjYyODExMDctZjgwYy00ZjQwLWI4OWYtOGFlYjA4ZjEzNmY1XkEyXkFqcGdeQXVyNTAyODkwOQ@@._V1_.jpg,"Drama, History, Thriller"
412,Beauty and the Beast,635,40,595,https://www.imdb.com/title/tt0101414/,https://m.media-amazon.com/images/M/MV5BMzE5MDM1NDktY2I0OC00YWI5LTk2NzUtYjczNDczOWQxYjM0XkEyXkFqcGdeQXVyMTQxNzMzNDI@._V1_.jpg,"Animation, Family, Fantasy"
413,Dances with Wolves,354,560,-206,https://www.imdb.com/title/tt0099348/,https://m.media-amazon.com/images/M/MV5BMTY3OTI5NDczN15BMl5BanBnXkFtZTcwNDA0NDY3Mw@@._V1_.jpg,"Adventure, Drama, Western"
415,Rain Man,370,365,5,https://www.imdb.com/title/tt0095953/,https://m.media-amazon.com/images/M/MV5BMzVjNzI4NzYtMjE4NS00M2IzLWFkOWMtOTYwMWUzN2ZlNGVjL2ltYWdlL2ltYWdlXkEyXkFqcGdeQXVyMTQxNzMzNDI@._V1_.jpg,Drama
416,Akira,378,709,-331,https://www.imdb.com/title/tt0094625/,https://m.media-amazon.com/images/M/MV5BNjFmNWYzZjMtYWIyZi00NDVmLWIxY2EtN2RiMjZiMDk4MzcyXkEyXkFqcGdeQXVyMTg2NjYzOA@@._V1_.jpg,"Animation, Action, Drama"
417,The Princess Bride,398,170,228,https://www.imdb.com/title/tt0093779/,https://m.media-amazon.com/images/M/MV5BYzdiOTVjZmQtNjAyNy00YjA2LTk5ZTAtNmJkMGQ5N2RmNjUxXkEyXkFqcGdeQXVyMjUzOTY1NTc@._V1_.jpg,"Adventure, Comedy, Family"
420,Castle in the Sky,374,412,-38,https://www.imdb.com/title/tt0092067/,https://m.media-amazon.com/images/M/MV5BNDFhZmY2NTgtMzljYy00MTlhLTgyMjItNTEwZWJkYThhYzkyXkEyXkFqcGdeQXVyNTgyNTA4MjM@._V1_.jpg,"Animation, Adventure, Family"
421,The Terminator,248,826,-578,https://www.imdb.com/title/tt0088247/,https://m.media-amazon.com/images/M/MV5BYTViNzMxZjEtZGEwNy00MDNiLWIzNGQtZDY2MjQ1OWViZjFmXkEyXkFqcGdeQXVyNzkwMjQ5NzM@._V1_.jpg,"Action, Adventure, Sci-Fi"
422,Gandhi,334,440,-106,https://www.imdb.com/title/tt0083987/,https://m.media-amazon.com/images/M/MV5BYjZiYmYwYjYtOTdlZS00OGM4LTg0NmQtOTg0OGMzMjkyYWM2XkEyXkFqcGdeQXVyMTUzMDUzNTI3._V1_.jpg,"Biography, Drama, History"
425,Annie Hall,368,725,-357,https://www.imdb.com/title/tt0075686/,https://m.media-amazon.com/images/M/MV5BZDg1OGQ4YzgtM2Y2NS00NjA3LWFjYTctMDRlMDI3NWE1OTUyXkEyXkFqcGdeQXVyMjUzOTY1NTc@._V1_.jpg,"Comedy, Romance"
426,Jaws,272,949,-677,https://www.imdb.com/title/tt0073195/,https://m.media-amazon.com/images/M/MV5BMmVmODY1MzEtYTMwZC00MzNhLWFkNDMtZjAwM2EwODUxZTA5XkEyXkFqcGdeQXVyNTAyODkwOQ@@._V1_.jpg,"Adventure, Drama, Thriller"
427,Dog Day Afternoon,341,369,-28,https://www.imdb.com/title/tt0072890/,https://m.media-amazon.com/images/M/MV5BODExZmE2ZWItYTIzOC00MzI1LTgyNTktMDBhNmFhY2Y4OTQ3XkEyXkFqcGdeQXVyNjU0OTQ0OTY@._V1_.jpg,"Biography, Crime, Drama"
428,Young Frankenstein,365,261,104,https://www.imdb.com/title/tt0072431/,https://m.media-amazon.com/images/M/MV5BMTEwNjg2MjM2ODFeQTJeQWpwZ15BbWU4MDQ1MDU5OTEx._V1_.jpg,Comedy
429,Papillon,325,477,-152,https://www.imdb.com/title/tt0070511/,https://m.media-amazon.com/images/M/MV5BZGRjZjQ0NzAtYmZlNS00Zjc1LTk1YWItMDY5YzQxMzA4MTAzXkEyXkFqcGdeQXVyMjI4MjA5MzA@._V1_.jpg,"Biography, Crime, Drama"
430,The Exorcist,309,676,-367,https://www.imdb.com/title/tt0070047/,https://m.media-amazon.com/images/M/MV5BYWFlZGY2NDktY2ZjOS00ZWNkLTg0ZDAtZDY4MTM1ODU4ZjljXkEyXkFqcGdeQXVyMjUzOTY1NTc@._V1_.jpg,Horror
435,Butch Cassidy and the Sundance Kid,304,344,-40,https://www.imdb.com/title/tt0064115/,https://m.media-amazon.com/images/M/MV5BMTkyMTM2NDk5Nl5BMl5BanBnXkFtZTgwNzY1NzEyMDE@._V1_.jpg,"Biography, Crime, Drama"
436,Rosemary's Baby,351,605,-254,https://www.imdb.com/title/tt0063522/,https://m.media-amazon.com/images/M/MV5BMTA5NWQwMmYtZjEyYS00Nzc2LTgwZjAtNTQ4NmFmZjNkNjg4XkEyXkFqcGdeQXVyMjUzOTY1NTc@._V1_.jpg,"Drama, Horror"
437,Planet of the Apes,427,870,-443,https://www.imdb.com/title/tt0063442/,https://m.media-amazon.com/images/M/MV5BZmNiNzJkYTQtNGUxMS00MWY4LTg0YjQtYmQ3MWY4NWUxYzBmXkEyXkFqcGdeQXVyNjc5NjEzNA@@._V1_.jpg,"Adventure, Sci-Fi"
438,The Graduate,343,636,-293,https://www.imdb.com/title/tt0061722/,https://m.media-amazon.com/images/M/MV5BMTQ0ODc4MDk4Nl5BMl5BanBnXkFtZTcwMTEzNzgzNA@@._V1_.jpg,"Comedy, Drama, Romance"
440,The Sound of Music,579,86,493,https://www.imdb.com/title/tt0059742/,https://m.media-amazon.com/images/M/MV5BYThiZTY5MTAtODgwNS00OGNjLThjYzItOTcxYmYxMGY5MzBjXkEyXkFqcGdeQXVyNjc5NjEzNA@@._V1_.jpg,"Biography, Drama, Family"
442,A Fistful of Dollars,392,881,-489,https://www.imdb.com/title/tt0058461/,https://m.media-amazon.com/images/M/MV5BY2M5MDA1YjUtODQ1Yi00M2JlLTk2ZWQtYjI0NTEwZDk2NGNhXkEyXkFqcGdeQXVyMjUzOTY1NTc@._V1_.jpg,"Action, Drama, Western"
443,8½,342,333,9,https://www.imdb.com/title/tt0056801/,https://m.media-amazon.com/images/M/MV5BNTkzZTZjOTgtYjgzMS00MTdkLWE2NDAtNTVmM2I3MGYyM2I0XkEyXkFqcGdeQXVyMjUzOTY1NTc@._V1_.jpg,Drama
457,Roman Holiday,457,211,246,https://www.imdb.com/title/tt0046250/,https://m.media-amazon.com/images/M/MV5BMTE2MDM4MTMtZmNkZC00Y2QyLWE0YjUtMTAxZGJmODMxMDM0XkEyXkFqcGdeQXVyNjc1NTYyMjg@._V1_.jpg,"Comedy, Drama, Romance"
458,A Streetcar Named Desire,446,249,197,https://www.imdb.com/title/tt0044081/,https://m.media-amazon.com/images/M/MV5BNzk2M2Y3MzYtNGMzMi00Y2FjLTkwODQtNmExYWU3ZWY3NzExXkEyXkFqcGdeQXVyNTA4NzY1MzY@._V1_.jpg,Drama
461,Rope,401,403,-2,https://www.imdb.com/title/tt0040746/,https://m.media-amazon.com/images/M/MV5BNGY4OTFlZTUtNDFjOC00NzM3LWI5ZjUtOWFkNTFhNzZhMmFkXkEyXkFqcGdeQXVyMTA0MTM5NjI2._V1_.jpg,"Crime, Drama, Mystery"
467,The Maltese Falcon,346,587,-241,https://www.imdb.com/title/tt0033870/,https://m.media-amazon.com/images/M/MV5BZjIwNGM1ZTUtOThjYS00NDdiLTk2ZDYtNGY5YjJkNzliM2JjL2ltYWdlL2ltYWdlXkEyXkFqcGdeQXVyMDI2NDg0NQ@@._V1_.jpg,"Crime, Film-Noir, Mystery"
469,The Wizard of Oz,394,180,214,https://www.imdb.com/title/tt0032138/,https://m.media-amazon.com/images/M/MV5BY2NjNDU1ZjctN2VhZi00Nzc5LTljNmItMTZiOTg1ODkwYjgwXkEyXkFqcGdeQXVyNTkxMzEwMzU@._V1_.jpg,"Adventure, Family, Fantasy"
474,Knives Out,532,734,-202,https://www.imdb.com/title/tt8946378/,https://m.media-amazon.com/images/M/MV5BMGUwZjliMTAtNzAxZi00MWNiLWE2NzgtZGUxMGQxZjhhNDRiXkEyXkFqcGdeQXVyNjU1NzU3MzE@._V1_.jpg,"Comedy, Crime, Drama"
476,Marriage Story,481,762,-281,https://www.imdb.com/title/tt7653254/,https://m.media-amazon.com/images/M/MV5BZGVmY2RjNDgtMTc3Yy00YmY0LTgwODItYzBjNWJhNTRlYjdkXkEyXkFqcGdeQXVyMjM4NTM5NDY@._V1_.jpg,"Drama, Romance"
477,Call Me by Your Name,794,167,627,https://www.imdb.com/title/tt5726616/,https://m.media-amazon.com/images/M/MV5BNDk3NTEwNjc0MV5BMl5BanBnXkFtZTgwNzYxNTMwMzI@._V1_.jpg,"Drama, Romance"
479,Isle of Dogs,654,376,278,https://www.imdb.com/title/tt5104604/,https://m.media-amazon.com/images/M/MV5BZDQwOWQ2NmUtZThjZi00MGM0LTkzNDctMzcyMjcyOGI1OGRkXkEyXkFqcGdeQXVyMTA3MDk2NDg2._V1_.jpg,"Animation, Adventure, Comedy"
480,Hunt for the Wilderpeople,712,237,475,https://www.imdb.com/title/tt4698684/,https://m.media-amazon.com/images/M/MV5BMjI1MDQ2MDg5Ml5BMl5BanBnXkFtZTgwMjc2NjM5ODE@._V1_.jpg,"Adventure, Comedy, Drama"
481,Captain Fantastic,578,442,136,https://www.imdb.com/title/tt3553976/,https://m.media-amazon.com/images/M/MV5BMjE5OTM0OTY5NF5BMl5BanBnXkFtZTgwMDcxOTQ3ODE@._V1_.jpg,"Comedy, Drama"
483,Thor: Ragnarok,587,329,258,https://www.imdb.com/title/tt3501632/,https://m.media-amazon.com/images/M/MV5BMjMyNDkzMzI1OF5BMl5BanBnXkFtZTgwODcxODg5MjI@._V1_.jpg,"Action, Adventure, Comedy"
484,Jojo Rabbit,591,230,361,https://www.imdb.com/title/tt2584384/,https://m.media-amazon.com/images/M/MV5BZjU0Yzk2MzEtMjAzYy00MzY0LTg2YmItM2RkNzdkY2ZhN2JkXkEyXkFqcGdeQXVyNDg4NjY5OTQ@._V1_.jpg,"Comedy, Drama, War"
485,Arrival,516,474,42,https://www.imdb.com/title/tt2543164/,https://m.media-amazon.com/images/M/MV5BMTExMzU0ODcxNDheQTJeQWpwZ15BbWU4MDE1OTI4MzAy._V1_.jpg,"Drama, Mystery, Sci-Fi"
486,Star Wars: Episode VII - The Force Awakens,571,233,338,https://www.imdb.com/title/tt2488496/,https://m.media-amazon.com/images/M/MV5BOTAzODEzNDAzMl5BMl5BanBnXkFtZTgwMDU1MTgzNzE@._V1_.jpg,"Action, Adventure, Sci-Fi"
487,Before Midnight,475,811,-336,https://www.imdb.com/title/tt2209418/,https://m.media-amazon.com/images/M/MV5BMjA5NzgxODE2NF5BMl5BanBnXkFtZTcwNTI1NTI0OQ@@._V1_.jpg,"Drama, Romance"
489,X-Men: Days of Future Past,447,316,131,https://www.imdb.com/title/tt1877832/,https://m.media-amazon.com/images/M/MV5BNjk3MGZhMjEtOTM4NC00NzE2LTk2NzctZDc4YTUwN2E3NDhhXkEyXkFqcGdeQXVyNDc2NjEyMw@@._V1_.jpg,"Action, Adventure, Sci-Fi"
492,The Artist,573,290,283,https://www.imdb.com/title/tt1655442/,https://m.media-amazon.com/images/M/MV5BNzYxMjBkNzAtY2M2YS00YjRhLTgzOTYtY2FiOGM2OTBlZjdiXkEyXkFqcGdeQXVyMTU3NDU4MDg2._V1_.jpg,"Comedy, Drama, Romance"
493,Edge of Tomorrow,480,792,-312,https://www.imdb.com/title/tt1631867/,https://m.media-amazon.com/images/M/MV5BMTc5OTk4MTM3M15BMl5BanBnXkFtZTgwODcxNjg3MDE@._V1_.jpg,"Action, Adventure, Sci-Fi"
496,Moon,538,576,-38,https://www.imdb.com/title/tt1182345/,https://m.media-amazon.com/images/M/MV5BMTgzODgyNTQwOV5BMl5BanBnXkFtZTcwNzc0NTc0Mg@@._V1_.jpg,"Drama, Mystery, Sci-Fi"
497,Let the Right One In,521,746,-225,https://www.imdb.com/title/tt1139797/,https://m.media-amazon.com/images/M/MV5BMjFjYmQ5OWItYTFiNy00Nzc5LTkyZGQtYmE0MDRhMjUwY2I5XkEyXkFqcGdeQXVyNTIzOTk5ODM@._V1_.jpg,"Drama, Fantasy, Horror"
498,District 9,406,906,-500,https://www.imdb.com/title/tt1136608/,https://m.media-amazon.com/images/M/MV5BMTM4OTI1OTM5NF5BMl5BanBnXkFtZTcwMzk5MTU1Mg@@._V1_.jpg,"Action, Sci-Fi, Thriller"
499,The Wrestler,537,1049,-512,https://www.imdb.com/title/tt1125849/,https://m.media-amazon.com/images/M/MV5BMTc5MjYyOTg4MF5BMl5BanBnXkFtZTcwNDc2MzQwMg@@._V1_.jpg,"Drama, Sport"
501,Boyhood,448,923,-475,https://www.imdb.com/title/tt1065073/,https://m.media-amazon.com/images/M/MV5BMTYzNDc2MDc0N15BMl5BanBnXkFtZTgwOTcwMDQ5MTE@._V1_.jpg,Drama
503,Star Trek,474,236,238,https://www.imdb.com/title/tt0796366/,https://m.media-amazon.com/images/M/MV5BMjE5NDQ5OTE4Ml5BMl5BanBnXkFtZTcwOTE3NDIzMw@@._V1_.jpg,"Action, Adventure, Sci-Fi"
504,In Bruges,496,760,-264,https://www.imdb.com/title/tt0780536/,https://m.media-amazon.com/images/M/MV5BMTUwOGFiM2QtOWMxYS00MjU2LThmZDMtZDM2MWMzNzllNjdhXkEyXkFqcGdeQXVyMTMxODk2OTU@._V1_.jpg,"Comedy, Crime, Drama"
505,The Man from Earth,428,1002,-574,https://www.imdb.com/title/tt0756683/,https://m.media-amazon.com/images/M/MV5BMzQ5NGQwOTUtNWJlZi00ZTFiLWI0ZTEtOGU3MTA2ZGU5OWZiXkEyXkFqcGdeQXVyMTczNjQwOTY@._V1_.jpg,"Drama, Fantasy, Mystery"
506,Letters from Iwo Jima,505,757,-252,https://www.imdb.com/title/tt0498380/,https://m.media-amazon.com/images/M/MV5BMjE0NzgwODI4M15BMl5BanBnXkFtZTcwNjg3OTA0MQ@@._V1_.jpg,"Action, Adventure, Drama"
507,The Fall,806,94,712,https://www.imdb.com/title/tt0460791/,https://m.media-amazon.com/images/M/MV5BMjAzODUwMjM1M15BMl5BanBnXkFtZTcwNjU2MjU2MQ@@._V1_.jpg,"Adventure, Drama, Fantasy"
508,Life of Pi,492,470,22,https://www.imdb.com/title/tt0454876/,https://m.media-amazon.com/images/M/MV5BNTg2OTY2ODg5OF5BMl5BanBnXkFtZTcwODM5MTYxOA@@._V1_.jpg,"Adventure, Drama, Fantasy"
509,Fantastic Mr. Fox,608,607,1,https://www.imdb.com/title/tt0432283/,https://m.media-amazon.com/images/M/MV5BOGUwYTU4NGEtNDM4MS00NDRjLTkwNmQtOTkwMWMyMjhmMjdlXkEyXkFqcGdeQXVyMTMxODk2OTU@._V1_.jpg,"Animation, Adventure, Comedy"
513,Iron Man,574,599,-25,https://www.imdb.com/title/tt0371746/,https://m.media-amazon.com/images/M/MV5BMTczNTI2ODUwOF5BMl5BanBnXkFtZTcwMTU0NTIzMw@@._V1_.jpg,"Action, Adventure, Sci-Fi"
514,Shaun of the Dead,517,541,-24,https://www.imdb.com/title/tt0365748/,https://m.media-amazon.com/images/M/MV5BMTg5Mjk2NDMtZTk0Ny00YTQ0LWIzYWEtMWI5MGQ0Mjg1OTNkXkEyXkFqcGdeQXVyNzkwMjQ5NzM@._V1_.jpg,"Comedy, Horror"
517,Mystic River,493,513,-20,https://www.imdb.com/title/tt0327056/,https://m.media-amazon.com/images/M/MV5BMTIzNDUyMjA4MV5BMl5BanBnXkFtZTYwNDc4ODM3._V1_.jpg,"Crime, Drama, Mystery"
518,Harry Potter and the Prisoner of Azkaban,723,165,558,https://www.imdb.com/title/tt0304141/,https://m.media-amazon.com/images/M/MV5BMTY4NTIwODg0N15BMl5BanBnXkFtZTcwOTc0MjEzMw@@._V1_.jpg,"Adventure, Family, Fantasy"
519,Hero,525,425,100,https://www.imdb.com/title/tt0299977/,https://m.media-amazon.com/images/M/MV5BMWQ2MjQ0OTctMWE1OC00NjZjLTk3ZDAtNTk3NTZiYWMxYTlmXkEyXkFqcGdeQXVyMTQxNzMzNDI@._V1_.jpg,"Action, Adventure, Drama"
520,Talk to Her,485,396,89,https://www.imdb.com/title/tt0287467/,https://m.media-amazon.com/images/M/MV5BMzBlNDhiMmMtNDVlNy00NjQ5LWJlYjEtYjc4ZTVjZjM4ZWIxXkEyXkFqcGdeQXVyMTMxODk2OTU@._V1_.jpg,"Drama, Mystery, Romance"
523,The Bourne Identity,476,778,-302,https://www.imdb.com/title/tt0258463/,https://m.media-amazon.com/images/M/MV5BM2JkNGU0ZGMtZjVjNS00NjgyLWEyOWYtZmRmZGQyN2IxZjA2XkEyXkFqcGdeQXVyNTIzOTk5ODM@._V1_.jpg,"Action, Mystery, Thriller"
525,Children of Men,508,1004,-496,https://www.imdb.com/title/tt0206634/,https://m.media-amazon.com/images/M/MV5BZjUzY2ZhZDAtZDRlNS00MzEzLTliZjItMzMyYzM2OTdkZGJjXkEyXkFqcGdeQXVyMjUzOTY1NTc@._V1_.jpg,"Action, Drama, Sci-Fi"
526,Almost Famous,506,755,-249,https://www.imdb.com/title/tt0181875/,https://m.media-amazon.com/images/M/MV5BYmZjZDUxYjgtZDY4Yi00MTY1LWE3ZTctOTIyNDA3ZGY5ZDZjXkEyXkFqcGdeQXVyMTUyNjc3NDQ4._V1_.jpg,"Adventure, Comedy, Drama"
527,Mulholland Dr.,470,818,-348,https://www.imdb.com/title/tt0166924/,https://m.media-amazon.com/images/M/MV5BYTRiMzg4NDItNTc3Zi00NjBjLTgwOWYtOGZjMTFmNGU4ODY4XkEyXkFqcGdeQXVyMjUzOTY1NTc@._V1_.jpg,"Drama, Mystery, Thriller"
528,Toy Story 2,519,765,-246,https://www.imdb.com/title/tt0120363/,https://m.media-amazon.com/images/M/MV5BMWM5ZDcxMTYtNTEyNS00MDRkLWI3YTItNThmMGExMWY4NDIwXkEyXkFqcGdeQXVyNjUwNzk3NDc@._V1_.jpg,"Animation, Adventure, Comedy"
529,Boogie Nights,511,1280,-769,https://www.imdb.com/title/tt0118749/,https://m.media-amazon.com/images/M/MV5BY2E2YWYxY2QtZmJmZi00MjJlLWFiYWItZTk5Y2IyMWQ1ZThhXkEyXkFqcGdeQXVyMTMxODk2OTU@._V1_.jpg,Drama
532,True Romance,467,685,-218,https://www.imdb.com/title/tt0108399/,https://m.media-amazon.com/images/M/MV5BYWRhYWJjNGEtMjNhNi00NzFkLTk1ZGUtNjNmM2FlNTNhNWRjXkEyXkFqcGdeQXVyNzkwMjQ5NzM@._V1_.jpg,"Crime, Drama, Romance"
535,Carlito's Way,533,947,-414,https://www.imdb.com/title/tt0106519/,https://m.media-amazon.com/images/M/MV5BYzBhY2E0OWYtYzRmNC00ZGY3LTllODYtNTExM2FmYTFkMGUwXkEyXkFqcGdeQXVyMjUzOTY1NTc@._V1_.jpg,"Crime, Drama, Thriller"
536,Edward Scissorhands,681,202,479,https://www.imdb.com/title/tt0099487/,https://m.media-amazon.com/images/M/MV5BMWY2MGRkNjgtZDczNi00YWJjLTkwNmUtMTY0NTE5ZDhkZjgwXkEyXkFqcGdeQXVyMjUzOTY1NTc@._V1_.jpg,"Drama, Fantasy, Romance"
539,The Untouchables,490,679,-189,https://www.imdb.com/title/tt0094226/,https://m.media-amazon.com/images/M/MV5BYTVjYWJmMWQtYWU4Ni00MWY3LWI2YmMtNTI5MDE0MWVmMmEzL2ltYWdlXkEyXkFqcGdeQXVyMTQxNzMzNDI@._V1_.jpg,"Crime, Drama, Thriller"
541,Brazil,527,558,-31,https://www.imdb.com/title/tt0088846/,https://m.media-amazon.com/images/M/MV5BMDM0YTM3Y2UtNzY5MC00OTc4LThhZTYtMmM0ZGZjMmU1ZjdmXkEyXkFqcGdeQXVyNjc1NTYyMjg@._V1_.jpg,"Drama, Sci-Fi, Thriller"
542,This Is Spinal Tap,483,585,-102,https://www.imdb.com/title/tt0088258/,https://m.media-amazon.com/images/M/MV5BMTQ2MTIzMzg5Nl5BMl5BanBnXkFtZTgwOTc5NDI1MDE@._V1_.jpg,"Comedy, Music"
543,A Christmas Story,455,366,89,https://www.imdb.com/title/tt0085334/,https://m.media-amazon.com/images/M/MV5BOWMyNjE0MzEtMzVjNy00NjIxLTg0ZjMtMWJhNGI1YmVjYTczL2ltYWdlXkEyXkFqcGdeQXVyNzc5MjA3OA@@._V1_.jpg,"Comedy, Family"
544,The Blues Brothers,491,732,-241,https://www.imdb.com/title/tt0080455/,https://m.media-amazon.com/images/M/MV5BYTdlMDExOGUtN2I3MS00MjY5LWE1NTAtYzc3MzIxN2M3OWY1XkEyXkFqcGdeQXVyNzkwMjQ5NzM@._V1_.jpg,"Action, Adventure, Comedy"
545,Manhattan,473,688,-215,https://www.imdb.com/title/tt0079522/,https://m.media-amazon.com/images/M/MV5BZGE2NjI5MjAtODQwYy00OGJkLWJiZTEtMTU0NzVlMTkzNjFjXkEyXkFqcGdeQXVyMTUzMDUzNTI3._V1_.jpg,"Comedy, Drama, Romance"
547,Dawn of the Dead,495,1226,-731,https://www.imdb.com/title/tt0077402/,https://m.media-amazon.com/images/M/MV5BMzc1YTIyNjctYzhlNy00ZmYzLWI2ZWQtMzk4MmQwYzA0NGQ1XkEyXkFqcGdeQXVyMTQxNzMzNDI@._V1_.jpg,"Horror, Thriller"
548,All the President's Men,441,386,55,https://www.imdb.com/title/tt0074119/,https://m.media-amazon.com/images/M/MV5BOWI2YWQxM2MtY2U4Yi00YjgzLTgwNzktN2ExNTgzNTIzMmUzXkEyXkFqcGdeQXVyMTAwMzUyOTc@._V1_.jpg,"Drama, History, Thriller"
556,Night of the Living Dead,523,859,-336,https://www.imdb.com/title/tt0063350/,https://m.media-amazon.com/images/M/MV5BMzRmN2E1ZDUtZDc2ZC00ZmI3LTkwOTctNzE2ZDIzMGJiMTYzXkEyXkFqcGdeQXVyMTQxNzMzNDI@._V1_.jpg,"Horror, Thriller"
561,Spartacus,462,866,-404,https://www.imdb.com/title/tt0054331/,https://m.media-amazon.com/images/M/MV5BMjc4MTUxN2UtMmU1NC00MjQyLTk3YTYtZTQ0YzEzZDc0Njc0XkEyXkFqcGdeQXVyNjU0OTQ0OTY@._V1_.jpg,"Adventure, Biography, Drama"
568,Strangers on a Train,432,423,9,https://www.imdb.com/title/tt0044079/,https://m.media-amazon.com/images/M/MV5BNWJjOGM4NmEtNDE2YS00OGEyLTkwZWItMGM4YzdhZDZhMzNhXkEyXkFqcGdeQXVyMDI2NDg0NQ@@._V1_.jpg,"Crime, Drama, Film-Noir"
581,The Gentlemen,705,674,31,https://www.imdb.com/title/tt8367814/,https://m.media-amazon.com/images/M/MV5BMTlkMmVmYjktYTc2NC00ZGZjLWEyOWUtMjc2MDMwMjQwOTA5XkEyXkFqcGdeQXVyNTI4MzE4MDU@._V1_.jpg,"Action, Crime"
585,Dunkirk,588,561,27,https://www.imdb.com/title/tt5013056/,https://m.media-amazon.com/images/M/MV5BN2YyZjQ0NTEtNzU5MS00NGZkLTg0MTEtYzJmMWY3MWRhZjM2XkEyXkFqcGdeQXVyMDA4NzMyOA@@._V1_.jpg,"Action, Drama, History"
587,Hidden Figures,835,166,669,https://www.imdb.com/title/tt4846340/,https://m.media-amazon.com/images/M/MV5BMzg2Mzg4YmUtNDdkNy00NWY1LWE3NmEtZWMwNGNlMzE5YzU3XkEyXkFqcGdeQXVyMjA5MTIzMjQ@._V1_.jpg,"Biography, Drama, History"
590,Kubo and the Two Strings,729,469,260,https://www.imdb.com/title/tt4302938/,https://m.media-amazon.com/images/M/MV5BMjA2Mzg2NDMzNl5BMl5BanBnXkFtZTgwMjcwODUzOTE@._V1_.jpg,"Animation, Action, Adventure"
592,Manchester by the Sea,619,950,-331,https://www.imdb.com/title/tt4034228/,https://m.media-amazon.com/images/M/MV5BMTYxMjk0NDg4Ml5BMl5BanBnXkFtZTgwODcyNjA5OTE@._V1_.jpg,Drama
594,Rogue One: A Star Wars Story,702,808,-106,https://www.imdb.com/title/tt3748528/,https://m.media-amazon.com/images/M/MV5BMjEwMzMxODIzOV5BMl5BanBnXkFtZTgwNzg3OTAzMDI@._V1_.jpg,"Action, Adventure, Sci-Fi"
595,Captain America: Civil War,677,695,-18,https://www.imdb.com/title/tt3498820/,https://m.media-amazon.com/images/M/MV5BMjQ0MTgyNjAxMV5BMl5BanBnXkFtZTgwNjUzMDkyODE@._V1_.jpg,"Action, Sci-Fi"
596,The Hateful Eight,539,1247,-708,https://www.imdb.com/title/tt3460252/,https://m.media-amazon.com/images/M/MV5BMjA1MTc1NTg5NV5BMl5BanBnXkFtZTgwOTM2MDEzNzE@._V1_.jpg,"Crime, Drama, Mystery"
597,Little Women,908,444,464,https://www.imdb.com/title/tt3281548/,https://m.media-amazon.com/images/M/MV5BY2QzYTQyYzItMzAwYi00YjZlLThjNTUtNzMyMDdkYzJiNWM4XkEyXkFqcGdeQXVyMTkxNjUyNQ@@._V1_.jpg,"Drama, Romance"
600,Nightcrawler,531,999,-468,https://www.imdb.com/title/tt2872718/,https://m.media-amazon.com/images/M/MV5BN2U1YzdhYWMtZWUzMi00OWI1LWFkM2ItNWVjM2YxMGQ2MmNhXkEyXkFqcGdeQXVyNjU0OTQ0OTY@._V1_.jpg,"Crime, Drama, Thriller"
605,Big Hero 6,830,240,590,https://www.imdb.com/title/tt2245084/,https://m.media-amazon.com/images/M/MV5BMDliOTIzNmUtOTllOC00NDU3LWFiNjYtMGM0NDc1YTMxNjYxXkEyXkFqcGdeQXVyNTM3NzExMDQ@._V1_.jpg,"Animation, Action, Adventure"
606,About Time,673,552,121,https://www.imdb.com/title/tt2194499/,https://m.media-amazon.com/images/M/MV5BMTA1ODUzMDA3NzFeQTJeQWpwZ15BbWU3MDgxMTYxNTk@._V1_.jpg,"Comedy, Drama, Fantasy"
609,Toy Story 4,770,775,-5,https://www.imdb.com/title/tt1979376/,https://m.media-amazon.com/images/M/MV5BMTYzMDM4NzkxOV5BMl5BanBnXkFtZTgwNzM1Mzg2NzM@._V1_.jpg,"Animation, Adventure, Comedy"
610,The Best Offer,692,548,144,https://www.imdb.com/title/tt1924396/,https://m.media-amazon.com/images/M/MV5BMTQ4MzQ3NjA0N15BMl5BanBnXkFtZTgwODQyNjQ4MDE@._V1_.jpg,"Crime, Drama, Mystery"
611,Moonrise Kingdom,695,596,99,https://www.imdb.com/title/tt1748122/,https://m.media-amazon.com/images/M/MV5BMTEwMTc3NDkzOTJeQTJeQWpwZ15BbWU3MDI4NTAwNzc@._V1_.jpg,"Adventure, Comedy, Drama"
612,How to Train Your Dragon 2,787,288,499,https://www.imdb.com/title/tt1646971/,https://m.media-amazon.com/images/M/MV5BMzMwMTAwODczN15BMl5BanBnXkFtZTgwMDk2NDA4MTE@._V1_.jpg,"Animation, Action, Adventure"
613,The Big Short,593,1033,-440,https://www.imdb.com/title/tt1596363/,https://m.media-amazon.com/images/M/MV5BNDc4MThhN2EtZjMzNC00ZDJmLThiZTgtNThlY2UxZWMzNjdkXkEyXkFqcGdeQXVyNDk3NzU2MTQ@._V1_.jpg,"Biography, Comedy, Drama"
615,I Saw the Devil,586,977,-391,https://www.imdb.com/title/tt1588170/,https://m.media-amazon.com/images/M/MV5BNmVkMGM0ZTQtNDQwNS00NzgwLTkwYWYtNWE3MWFiOGUwODg5XkEyXkFqcGdeQXVyMTMxODk2OTU@._V1_.jpg,"Action, Crime, Thriller"
616,The Girl with the Dragon Tattoo,589,382,207,https://www.imdb.com/title/tt1568346/,https://m.media-amazon.com/images/M/MV5BMTczNDk4NTQ0OV5BMl5BanBnXkFtZTcwNDAxMDgxNw@@._V1_.jpg,"Crime, Drama, Mystery"
617,Captain Phillips,643,609,34,https://www.imdb.com/title/tt1535109/,https://m.media-amazon.com/images/M/MV5BODhiZWRhMjctNDUyMS00NmUwLTgwYmItMjJhOWNkZWQ3ZTQxXkEyXkFqcGdeQXVyMTMxODk2OTU@._V1_.jpg,"Action, Biography, Crime"
619,Straight Outta Compton,650,566,84,https://www.imdb.com/title/tt1398426/,https://m.media-amazon.com/images/M/MV5BMTA5MzkyMzIxNjJeQTJeQWpwZ15BbWU4MDU0MDk0OTUx._V1_.jpg,"Biography, Drama, History"
620,The Irishman,548,1503,-955,https://www.imdb.com/title/tt1302006/,https://m.media-amazon.com/images/M/MV5BMGUyM2ZiZmUtMWY0OC00NTQ4LThkOGUtNjY2NjkzMDJiMWMwXkEyXkFqcGdeQXVyMzY0MTE3NzU@._V1_.jpg,"Biography, Crime, Drama"
623,The Hobbit: The Desolation of Smaug,687,358,329,https://www.imdb.com/title/tt1170358/,https://m.media-amazon.com/images/M/MV5BMzU0NDY0NDEzNV5BMl5BanBnXkFtZTgwOTIxNDU1MDE@._V1_.jpg,"Adventure, Drama, Fantasy"
625,The Girl with the Dragon Tattoo,589,382,207,https://www.imdb.com/title/tt1132620/,https://m.media-amazon.com/images/M/MV5BMTc2Mjc0MDg3MV5BMl5BanBnXkFtZTcwMjUzMDkxMw@@._V1_.jpg,"Crime, Drama, Mystery"
626,Skyfall,715,896,-181,https://www.imdb.com/title/tt1074638/,https://m.media-amazon.com/images/M/MV5BMWZiNjE2OWItMTkwNy00ZWQzLWI0NTgtMWE0NjNiYTljN2Q1XkEyXkFqcGdeQXVyNzAwMjYxMzA@._V1_.jpg,"Action, Adventure, Thriller"
627,The Trial of the Chicago 7,733,453,280,https://www.imdb.com/title/tt1070874/,https://m.media-amazon.com/images/M/MV5BYjYzOGE1MjUtODgyMy00ZDAxLTljYTgtNzk0Njg2YWQwMTZhXkEyXkFqcGdeQXVyMDM2NDM2MQ@@._V1_.jpg,"Drama, History, Thriller"
629,The Fighter,598,802,-204,https://www.imdb.com/title/tt0964517/,https://m.media-amazon.com/images/M/MV5BMTM0ODk3MjM1MV5BMl5BanBnXkFtZTcwNzc1MDIwNA@@._V1_.jpg,"Action, Biography, Drama"
630,Taken,652,837,-185,https://www.imdb.com/title/tt0936501/,https://m.media-amazon.com/images/M/MV5BZDA0ODYzZGMtOGI3ZS00YTdjLTk0ZjEtYzA0Zjg3MDM4OTA4XkEyXkFqcGdeQXVyMTUzMDUzNTI3._V1_.jpg,"Action, Crime, Thriller"
631,The Boy in the Striped Pajamas,885,226,659,https://www.imdb.com/title/tt0914798/,https://m.media-amazon.com/images/M/MV5BMTMzMTc3MjA5NF5BMl5BanBnXkFtZTcwOTk3MDE5MQ@@._V1_.jpg,"Drama, War"
632,Once,546,900,-354,https://www.imdb.com/title/tt0907657/,https://m.media-amazon.com/images/M/MV5BYWUxZjJkMDktZmMxMS00Mzg3LTk4MDItN2IwODlmN2E0MTM0XkEyXkFqcGdeQXVyMTMxODk2OTU@._V1_.jpg,"Drama, Music, Romance"
633,The Hobbit: An Unexpected Journey,606,306,300,https://www.imdb.com/title/tt0903624/,https://m.media-amazon.com/images/M/MV5BMTcwNTE4MTUxMl5BMl5BanBnXkFtZTcwMDIyODM4OA@@._V1_.jpg,"Adventure, Fantasy"
635,Atonement,784,504,280,https://www.imdb.com/title/tt0783233/,https://m.media-amazon.com/images/M/MV5BMGRiYjE0YzItMzk3Zi00ZmYwLWJjNDktYTAwYjIwMjIxYzM3XkEyXkFqcGdeQXVyMTMxODk2OTU@._V1_.jpg,"Drama, Mystery, Romance"
636,Drive,597,1238,-641,https://www.imdb.com/title/tt0780504/,https://m.media-amazon.com/images/M/MV5BZjY5ZjQyMjMtMmEwOC00Nzc2LTllYTItMmU2MzJjNTg1NjY0XkEyXkFqcGdeQXVyNjQ1MTMzMDQ@._V1_.jpg,"Action, Drama"
637,American Gangster,605,1024,-419,https://www.imdb.com/title/tt0765429/,https://m.media-amazon.com/images/M/MV5BMjFmZGI2YTEtYmJhMS00YTE5LWJjNjAtNDI5OGY5ZDhmNTRlXkEyXkFqcGdeQXVyODAwMTU1MTE@._V1_.jpg,"Biography, Crime, Drama"
638,Avatar,552,899,-347,https://www.imdb.com/title/tt0499549/,https://m.media-amazon.com/images/M/MV5BZDA0OGQxNTItMDZkMC00N2UyLTg3MzMtYTJmNjg3Nzk5MzRiXkEyXkFqcGdeQXVyMjUzOTY1NTc@._V1_.jpg,"Action, Adventure, Fantasy"
639,Mr. Nobody,631,515,116,https://www.imdb.com/title/tt0485947/,https://m.media-amazon.com/images/M/MV5BMTg4ODkzMDQ3Nl5BMl5BanBnXkFtZTgwNTEwMTkxMDE@._V1_.jpg,"Drama, Fantasy, Romance"
640,Apocalypto,616,615,1,https://www.imdb.com/title/tt0472043/,https://m.media-amazon.com/images/M/MV5BMzhmNGMzMDMtZDM0Yi00MmVmLWExYjAtZDhjZjcxZDM0MzJhXkEyXkFqcGdeQXVyNjU0OTQ0OTY@._V1_.jpg,"Action, Adventure, Drama"
641,Little Miss Sunshine,656,438,218,https://www.imdb.com/title/tt0449059/,https://m.media-amazon.com/images/M/MV5BMTgzNTgzODU0NV5BMl5BanBnXkFtZTcwMjEyMjMzMQ@@._V1_.jpg,"Comedy, Drama"
642,Hot Fuzz,604,628,-24,https://www.imdb.com/title/tt0425112/,https://m.media-amazon.com/images/M/MV5BMzg4MDJhMDMtYmJiMS00ZDZmLThmZWUtYTMwZDM1YTc5MWE2XkEyXkFqcGdeQXVyNjU0OTQ0OTY@._V1_.jpg,"Action, Comedy, Mystery"
643,The Curious Case of Benjamin Button,599,704,-105,https://www.imdb.com/title/tt0421715/,https://m.media-amazon.com/images/M/MV5BMzI4M2I1MTItYjdiYi00YTZhLTg0NDgtZWIzOGU5ZmM3NWZlXkEyXkFqcGdeQXVyODE5NzE3OTE@._V1_.jpg,"Drama, Fantasy, Romance"
646,Pride & Prejudice,1223,213,1010,https://www.imdb.com/title/tt0414387/,https://m.media-amazon.com/images/M/MV5BMTA1NDQ3NTcyOTNeQTJeQWpwZ15BbWU3MDA0MzA4MzE@._V1_.jpg,"Drama, Romance"
648,Serenity,617,235,382,https://www.imdb.com/title/tt0379786/,https://m.media-amazon.com/images/M/MV5BMTc5YjQ0MGQtOTdjZS00OGZhLTk1ZGItMThjOGFiZmMxYWRjL2ltYWdlL2ltYWdlXkEyXkFqcGdeQXVyMTQxNzMzNDI@._V1_.jpg,"Action, Adventure, Sci-Fi"
649,Walk the Line,620,398,222,https://www.imdb.com/title/tt0358273/,https://m.media-amazon.com/images/M/MV5BMjIyOTU3MjUxOF5BMl5BanBnXkFtZTcwMTQ0NjYzMw@@._V1_.jpg,"Biography, Drama, Music"
651,The Notebook,841,216,625,https://www.imdb.com/title/tt0332280/,https://m.media-amazon.com/images/M/MV5BNzc3Mzg1OGYtZjc3My00Y2NhLTgyOWUtYjRhMmI4OTkwNDg4XkEyXkFqcGdeQXVyMTU3NDU4MDg2._V1_.jpg,"Drama, Romance"
656,The Count of Monte Cristo,793,611,182,https://www.imdb.com/title/tt0245844/,https://m.media-amazon.com/images/M/MV5BMDM0ZWRjZDgtZWI0MS00ZTIzLTg4MWYtZjU5MDEyMDU0ODBjXkEyXkFqcGdeQXVyMTQxNzMzNDI@._V1_.jpg,"Action, Adventure, Drama"
658,Remember the Titans,764,456,308,https://www.imdb.com/title/tt0210945/,https://m.media-amazon.com/images/M/MV5BYThkMzgxNjEtMzFiOC00MTI0LWI5MDItNDVmYjA4NzY5MDQ2L2ltYWdlL2ltYWdlXkEyXkFqcGdeQXVyMTQxNzMzNDI@._V1_.jpg,"Biography, Comedy, Drama"
659,"Crouching Tiger, Hidden Dragon",584,600,-16,https://www.imdb.com/title/tt0190332/,https://m.media-amazon.com/images/M/MV5BNDdhMzMxOTctNDMyNS00NTZmLTljNWEtNTc4MDBmZTYxY2NmXkEyXkFqcGdeQXVyNjU0OTQ0OTY@._V1_.jpg,"Action, Adventure, Drama"
661,Cast Away,610,915,-305,https://www.imdb.com/title/tt0162222/,https://m.media-amazon.com/images/M/MV5BN2Y5ZTU4YjctMDRmMC00MTg4LWE1M2MtMjk4MzVmOTE4YjkzXkEyXkFqcGdeQXVyNTc1NTQxODI@._V1_.jpg,"Adventure, Drama, Romance"
662,The Boondock Saints,716,319,397,https://www.imdb.com/title/tt0144117/,https://m.media-amazon.com/images/M/MV5BNTliMTg0ZTgtNTJiYi00MjFkLThhYTUtNDAwNTliMmVkNjVkXkEyXkFqcGdeQXVyMjUzOTY1NTc@._V1_.jpg,"Action, Crime, Thriller"
663,The Insider,630,946,-316,https://www.imdb.com/title/tt0140352/,https://m.media-amazon.com/images/M/MV5BODg0YjAzNDQtOGFkMi00Yzk2LTg1NzYtYTNjY2UwZTM2ZDdkL2ltYWdlXkEyXkFqcGdeQXVyMTQxNzMzNDI@._V1_.jpg,"Biography, Drama, History"
665,Shrek,564,445,119,https://www.imdb.com/title/tt0126029/,https://m.media-amazon.com/images/M/MV5BOGZhM2FhNTItODAzNi00YjA0LWEyN2UtNjJlYWQzYzU1MDg5L2ltYWdlL2ltYWdlXkEyXkFqcGdeQXVyMTQxNzMzNDI@._V1_.jpg,"Animation, Adventure, Comedy"
666,Titanic,820,289,531,https://www.imdb.com/title/tt0120338/,https://m.media-amazon.com/images/M/MV5BMDdmZGU3NDQtY2E5My00ZTliLWIzOTUtMTY4ZGI1YjdiNjk3XkEyXkFqcGdeQXVyNTA4NzY1MzY@._V1_.jpg,"Drama, Romance"
668,Gattaca,672,742,-70,https://www.imdb.com/title/tt0119177/,https://m.media-amazon.com/images/M/MV5BOWRhZDMwMzEtNDYzNy00N2U4LWIzNGMtMmIyY2M3YWFjM2VkXkEyXkFqcGdeQXVyMTQxNzMzNDI@._V1_.jpg,"Drama, Sci-Fi, Thriller"
669,The Game,661,935,-274,https://www.imdb.com/title/tt0119174/,https://m.media-amazon.com/images/M/MV5BNWQ2ODFhNWItNTA4NS00MzkyLTgyYzUtZjlhYWE5MmEzY2Q1XkEyXkFqcGdeQXVyMjUzOTY1NTc@._V1_.jpg,"Drama, Mystery, Thriller"
671,Ed Wood,609,1015,-406,https://www.imdb.com/title/tt0109707/,https://m.media-amazon.com/images/M/MV5BNTA5ZjdjNWUtZGUwNy00N2RhLWJiZmItYzFhYjU1NmYxNjY4XkEyXkFqcGdeQXVyMTQxNzMzNDI@._V1_.jpg,"Biography, Comedy, Drama"
672,What's Eating Gilbert Grape,872,462,410,https://www.imdb.com/title/tt0108550/,https://m.media-amazon.com/images/M/MV5BY2EyZDlhNjItODYzNi00Mzc3LWJjOWUtMTViODU5MTExZWMyL2ltYWdlXkEyXkFqcGdeQXVyMTQxNzMzNDI@._V1_.jpg,Drama
673,Tombstone,628,435,193,https://www.imdb.com/title/tt0108358/,https://m.media-amazon.com/images/M/MV5BODRkYzA4MGItODE2MC00ZjkwLWI2NDEtYzU1NzFiZGU1YzA0XkEyXkFqcGdeQXVyNTAyODkwOQ@@._V1_.jpg,"Biography, Drama, History"
677,The Fugitive,615,897,-282,https://www.imdb.com/title/tt0106977/,https://m.media-amazon.com/images/M/MV5BYmFmOGZjYTItYjY1ZS00OWRiLTk0NDgtMjQ5MzBkYWE2YWE0XkEyXkFqcGdeQXVyNjU0OTQ0OTY@._V1_.jpg,"Action, Crime, Drama"
678,A Bronx Tale,732,667,65,https://www.imdb.com/title/tt0106489/,https://m.media-amazon.com/images/M/MV5BOTY5OGI3ZWQtNzk3ZS00YTYxLWJhZWEtMjc5YTJkZmMzOWJhXkEyXkFqcGdeQXVyMTUzMDUzNTI3._V1_.jpg,"Crime, Drama"
683,Boyz n the Hood,768,835,-67,https://www.imdb.com/title/tt0101507/,https://m.media-amazon.com/images/M/MV5BZmRjNDI5NTgtOTIwMC00MzJhLWI4ZTYtMmU0ZTE3ZmRkZDNhXkEyXkFqcGdeQXVyMTQxNzMzNDI@._V1_.jpg,"Crime, Drama"
684,Misery,621,528,93,https://www.imdb.com/title/tt0100157/,https://m.media-amazon.com/images/M/MV5BNzY0ODQ3MTMxN15BMl5BanBnXkFtZTgwMDkwNTg4NjE@._V1_.jpg,"Drama, Thriller"
685,Awakenings,641,406,235,https://www.imdb.com/title/tt0099077/,https://m.media-amazon.com/images/M/MV5BMWUxOTk2NzUtZDBjYi00MzIwLWFlODYtZjFmNDM5MjlkYjJjXkEyXkFqcGdeQXVyMjUzOTY1NTc@._V1_.jpg,"Biography, Drama"
686,Kiki's Delivery Service,662,455,207,https://www.imdb.com/title/tt0097814/,https://m.media-amazon.com/images/M/MV5BYTQ1ZTM1ZTgtN2Q2Ny00YjFkLTliNjEtN2I1ZmY5ZTY1OTEzXkEyXkFqcGdeQXVyMTMxODk2OTU@._V1_.jpg,"Animation, Family, Fantasy"
687,Glory,596,542,54,https://www.imdb.com/title/tt0097441/,https://m.media-amazon.com/images/M/MV5BODhlNjA5MDEtZDVhNS00ZmM3LTg1YzAtZGRjNjhjNTAzNzVkXkEyXkFqcGdeQXVyNjUwMzI2NzU@._V1_.jpg,"Biography, Drama, History"
689,Back to the Future Part II,566,787,-221,https://www.imdb.com/title/tt0096874/,https://m.media-amazon.com/images/M/MV5BZTMxMGM5MjItNDJhNy00MWI2LWJlZWMtOWFhMjI5ZTQwMWM3XkEyXkFqcGdeQXVyMTQxNzMzNDI@._V1_.jpg,"Adventure, Comedy, Sci-Fi"
691,Predator,551,1657,-1106,https://www.imdb.com/title/tt0093773/,https://m.media-amazon.com/images/M/MV5BY2QwYmFmZTEtNzY2Mi00ZWMyLWEwY2YtMGIyNGZjMWExOWEyXkEyXkFqcGdeQXVyNjUwNzk3NDc@._V1_.jpg,"Action, Adventure, Horror"
692,Evil Dead II,646,1463,-817,https://www.imdb.com/title/tt0092991/,https://m.media-amazon.com/images/M/MV5BMWY3ODZlOGMtNzJmOS00ZTNjLWI3ZWEtZTJhZTk5NDZjYWRjXkEyXkFqcGdeQXVyNjU0OTQ0OTY@._V1_.jpg,"Comedy, Horror"
693,Ferris Bueller's Day Off,667,658,9,https://www.imdb.com/title/tt0091042/,https://m.media-amazon.com/images/M/MV5BMDA0NjZhZWUtNmI2NC00MmFjLTgwZDYtYzVjZmNhMDVmOTBkXkEyXkFqcGdeQXVyMTQxNzMzNDI@._V1_.jpg,Comedy
695,The Goonies,769,392,377,https://www.imdb.com/title/tt0089218/,https://m.media-amazon.com/images/M/MV5BNTNmZDc0ZDEtZjY3Ni00YmVjLTljNWQtMTE3NDAxNWFhMDk4XkEyXkFqcGdeQXVyMTUzMDUzNTI3._V1_.jpg,"Adventure, Comedy, Family"
697,The Breakfast Club,657,391,266,https://www.imdb.com/title/tt0088847/,https://m.media-amazon.com/images/M/MV5BOTM5N2ZmZTMtNjlmOS00YzlkLTk3YjEtNTU1ZmQ5OTdhODZhXkEyXkFqcGdeQXVyMTQxNzMzNDI@._V1_.jpg,"Comedy, Drama"
699,Ghostbusters,691,1076,-385,https://www.imdb.com/title/tt0087332/,https://m.media-amazon.com/images/M/MV5BZmYxNzdiMGItMDNlMS00ZWYyLWIwOTItZDcyMTNiNTZiMzJhXkEyXkFqcGdeQXVyNzkwMjQ5NzM@._V1_.jpg,"Action, Comedy, Fantasy"
702,E.T. the Extra-Terrestrial,559,520,39,https://www.imdb.com/title/tt0083866/,https://m.media-amazon.com/images/M/MV5BMTQ2ODFlMDAtNzdhOC00ZDYzLWE3YTMtNDU4ZGFmZmJmYTczXkEyXkFqcGdeQXVyMTQxNzMzNDI@._V1_.jpg,"Adventure, Family, Sci-Fi"
703,Kramer vs. Kramer,674,692,-18,https://www.imdb.com/title/tt0079417/,https://m.media-amazon.com/images/M/MV5BYjkzOTQ1NjgtNWI1Zi00ODcwLThlZGMtMWQyYjFlMjUxNzg1XkEyXkFqcGdeQXVyMjUzOTY1NTc@._V1_.jpg,Drama
707,The Conversation,570,879,-309,https://www.imdb.com/title/tt0071360/,https://m.media-amazon.com/images/M/MV5BMzlmOTUxOGUtY2UwNS00MmZhLThlNGEtMTNiNTg5OWEzMTczXkEyXkFqcGdeQXVyNDE0OTU3NDY@._V1_.jpg,"Drama, Mystery, Thriller"
712,Willy Wonka & the Chocolate Factory,648,549,99,https://www.imdb.com/title/tt0067992/,https://m.media-amazon.com/images/M/MV5BZTllNDU0ZTItYTYxMC00OTI4LThlNDAtZjNiNzdhMWZiYjNmXkEyXkFqcGdeQXVyNzY1NDgwNjQ@._V1_.jpg,"Adventure, Comedy, Family"
713,Midnight Cowboy,557,805,-248,https://www.imdb.com/title/tt0064665/,https://m.media-amazon.com/images/M/MV5BZmFlZDZmMTYtZjczOS00M2M0LWIxYzItYmRjM2IxYTg4NDg2XkEyXkFqcGdeQXVyMjUzOTY1NTc@._V1_.jpg,Drama
716,Bonnie and Clyde,701,831,-130,https://www.imdb.com/title/tt0061418/,https://m.media-amazon.com/images/M/MV5BMTNjNzBlY2QtNmY1Ni00MzhkLThmODgtMzc3ZDQ0YzJjZjNlXkEyXkFqcGdeQXVyMjUzOTY1NTc@._V1_.jpg,"Action, Biography, Crime"
718,Mary Poppins,857,298,559,https://www.imdb.com/title/tt0058331/,https://m.media-amazon.com/images/M/MV5BNmJkODczNjItNDI5Yy00MGI1LTkyOWItZDNmNjM4ZGI1ZDVlL2ltYWdlL2ltYWdlXkEyXkFqcGdeQXVyMDI2NDg0NQ@@._V1_.jpg,"Comedy, Family, Fantasy"
736,Roma,822,952,-130,https://www.imdb.com/title/tt6155172/,https://m.media-amazon.com/images/M/MV5BMTU0OTc3ODk4Ml5BMl5BanBnXkFtZTgwMzM4NzI5NjM@._V1_.jpg,Drama
738,Deadpool 2,852,797,55,https://www.imdb.com/title/tt5463162/,https://m.media-amazon.com/images/M/MV5BMTQ0NTk2MTYtMWZlYS00ZTliLThmZTEtNDVkODgxNmQ2ZGM2XkEyXkFqcGdeQXVyNTc4MjczMTM@._V1_.jpg,"Action, Adventure, Comedy"
739,Wind River,816,945,-129,https://www.imdb.com/title/tt5362988/,https://m.media-amazon.com/images/M/MV5BMTUyMjU1OTUwM15BMl5BanBnXkFtZTgwMDg1NDQ2MjI@._V1_.jpg,"Crime, Drama, Mystery"
740,Get Out,825,832,-7,https://www.imdb.com/title/tt5052448/,https://m.media-amazon.com/images/M/MV5BMjUxMDQwNjcyNl5BMl5BanBnXkFtZTgwNzcwMzc0MTI@._V1_.jpg,"Horror, Mystery, Thriller"
741,Mission: Impossible - Fallout,756,1285,-529,https://www.imdb.com/title/tt4912910/,https://m.media-amazon.com/images/M/MV5BNjRlZmM0ODktY2RjNS00ZDdjLWJhZGYtNDljNWZkMGM5MTg0XkEyXkFqcGdeQXVyNjAwMjI5MDk@._V1_.jpg,"Action, Adventure, Thriller"
744,What We Do in the Shadows,890,476,414,https://www.imdb.com/title/tt3416742/,https://m.media-amazon.com/images/M/MV5BYmYyYWY4NjgtNGQ2Yi00NDNiLWJlOTgtYjI1MTI0NjZkNjhhXkEyXkFqcGdeQXVyNDE5MTU2MDE@._V1_.jpg,"Comedy, Horror"
746,The Theory of Everything,936,478,458,https://www.imdb.com/title/tt2980516/,https://m.media-amazon.com/images/M/MV5BMTAwMTU4MDA3NDNeQTJeQWpwZ15BbWU4MDk4NTMxNTIx._V1_.jpg,"Biography, Drama, Romance"
747,Kingsman: The Secret Service,805,666,139,https://www.imdb.com/title/tt2802144/,https://m.media-amazon.com/images/M/MV5BYTM3ZTllNzItNTNmOS00NzJiLTg1MWMtMjMxNDc0NmJhODU5XkEyXkFqcGdeQXVyODE5NzE3OTE@._V1_.jpg,"Action, Adventure, Comedy"
748,The Fault in Our Stars,884,669,215,https://www.imdb.com/title/tt2582846/,https://m.media-amazon.com/images/M/MV5BNTVkMTFiZWItOTFkOC00YTc3LWFhYzQtZTg3NzAxZjJlNTAyXkEyXkFqcGdeQXVyODE5NzE3OTE@._V1_.jpg,"Drama, Romance"
749,Me and Earl and the Dying Girl,727,788,-61,https://www.imdb.com/title/tt2582496/,https://m.media-amazon.com/images/M/MV5BNTA1NzUzNjY4MV5BMl5BanBnXkFtZTgwNDU0MDI0NTE@._V1_.jpg,"Comedy, Drama"
750,Birdman or (The Unexpected Virtue of Ignorance),645,1336,-691,https://www.imdb.com/title/tt2562232/,https://m.media-amazon.com/images/M/MV5BODAzNDMxMzAxOV5BMl5BanBnXkFtZTgwMDMxMjA4MjE@._V1_.jpg,"Comedy, Drama"
751,Blue Is the Warmest Colour,734,904,-170,https://www.imdb.com/title/tt2278871/,https://m.media-amazon.com/images/M/MV5BMTQ5NTg5ODk4OV5BMl5BanBnXkFtZTgwODc4MTMzMDE@._V1_.jpg,"Drama, Romance"
754,Captain America: The Winter Soldier,780,618,162,https://www.imdb.com/title/tt1843866/,https://m.media-amazon.com/images/M/MV5BYzMyN2I0NjMtYmZhZS00MWJkLWE1MTktNGM2ZDhmNDE1ZDc0XkEyXkFqcGdeQXVyNDg2NzE0MjE@._V1_.jpg,"Action, Adventure, Sci-Fi"
756,Nebraska,703,790,-87,https://www.imdb.com/title/tt1821549/,https://m.media-amazon.com/images/M/MV5BYWY3ZDcwNjctMTRmMS00ZWVlLTk4NGItODgxYjU3MjcwNGUxXkEyXkFqcGdeQXVyMTcwOTQzOTYy._V1_.jpg,Drama
757,Wreck-It Ralph,788,823,-35,https://www.imdb.com/title/tt1772341/,https://m.media-amazon.com/images/M/MV5BNzMxNTExOTkyMF5BMl5BanBnXkFtZTcwMzEyNDc0OA@@._V1_.jpg,"Animation, Adventure, Comedy"
760,Midnight in Paris,845,1106,-261,https://www.imdb.com/title/tt1605783/,https://m.media-amazon.com/images/M/MV5BMTM4NjY1MDQwMl5BMl5BanBnXkFtZTcwNTI3Njg3NA@@._V1_.jpg,"Comedy, Fantasy, Romance"
761,The Lego Movie,666,995,-329,https://www.imdb.com/title/tt1490017/,https://m.media-amazon.com/images/M/MV5BMTg4MDk1ODExN15BMl5BanBnXkFtZTgwNzIyNjg3MDE@._V1_.jpg,"Animation, Action, Adventure"
762,Gravity,676,1366,-690,https://www.imdb.com/title/tt1454468/,https://m.media-amazon.com/images/M/MV5BNjE5MzYwMzYxMF5BMl5BanBnXkFtZTcwOTk4MTk0OQ@@._V1_.jpg,"Drama, Sci-Fi, Thriller"
763,Star Trek Into Darkness,866,429,437,https://www.imdb.com/title/tt1408101/,https://m.media-amazon.com/images/M/MV5BMTk2NzczOTgxNF5BMl5BanBnXkFtZTcwODQ5ODczOQ@@._V1_.jpg,"Action, Adventure, Sci-Fi"
765,The Social Network,663,1497,-834,https://www.imdb.com/title/tt1285016/,https://m.media-amazon.com/images/M/MV5BOGUyZDUxZjEtMmIzMC00MzlmLTg4MGItZWJmMzBhZjE0Mjc1XkEyXkFqcGdeQXVyMTMxODk2OTU@._V1_.jpg,"Biography, Drama"
766,X-Men: First Class,754,579,175,https://www.imdb.com/title/tt1270798/,https://m.media-amazon.com/images/M/MV5BMTg5OTMxNzk4Nl5BMl5BanBnXkFtZTcwOTk1MjAwNQ@@._V1_.jpg,"Action, Sci-Fi"
767,The Hangover,678,1242,-564,https://www.imdb.com/title/tt1119646/,https://m.media-amazon.com/images/M/MV5BNGQwZjg5YmYtY2VkNC00NzliLTljYTctNzI5NmU3MjE2ODQzXkEyXkFqcGdeQXVyNzkwMjQ5NzM@._V1_.jpg,Comedy
768,Silver Linings Playbook,699,980,-281,https://www.imdb.com/title/tt1045658/,https://m.media-amazon.com/images/M/MV5BMTM2MTI5NzA3MF5BMl5BanBnXkFtZTcwODExNTc0OA@@._V1_.jpg,"Comedy, Drama, Romance"
769,Argo,859,653,206,https://www.imdb.com/title/tt1024648/,https://m.media-amazon.com/images/M/MV5BNzljNjY3MDYtYzc0Ni00YjU0LWIyNDUtNTE0ZDRiMGExMjZlXkEyXkFqcGdeQXVyMTMxODk2OTU@._V1_.jpg,"Biography, Drama, History"
770,500 Days of Summer,747,1222,-475,https://www.imdb.com/title/tt1022603/,https://m.media-amazon.com/images/M/MV5BMTk5MjM4OTU1OV5BMl5BanBnXkFtZTcwODkzNDIzMw@@._V1_.jpg,"Comedy, Drama, Romance"
771,Harry Potter and the Deathly Hallows: Part 1,1146,187,959,https://www.imdb.com/title/tt0926084/,https://m.media-amazon.com/images/M/MV5BMTQ2OTE1Mjk0N15BMl5BanBnXkFtZTcwODE3MDAwNA@@._V1_.jpg,"Adventure, Family, Fantasy"
772,Ponyo,937,690,247,https://www.imdb.com/title/tt0876563/,https://m.media-amazon.com/images/M/MV5BOTc3YmM3N2QtODZkMC00ZDE5LThjMTQtYTljN2Y1YTYwYWJkXkEyXkFqcGdeQXVyODEzNjM5OTQ@._V1_.jpg,"Animation, Adventure, Comedy"
773,Frost/Nixon,821,873,-52,https://www.imdb.com/title/tt0870111/,https://m.media-amazon.com/images/M/MV5BYTdmMWVmMmEtZTExOS00YzFhLWI3MGUtZDc5MjBhMjNjOWMzXkEyXkFqcGdeQXVyMjUzOTY1NTc@._V1_.jpg,"Biography, Drama, History"
775,Changeling,752,756,-4,https://www.imdb.com/title/tt0824747/,https://m.media-amazon.com/images/M/MV5BOTA1Mzg3NjIxNV5BMl5BanBnXkFtZTcwNzU2NTc5MQ@@._V1_.jpg,"Biography, Crime, Drama"
779,This Is England,896,834,62,https://www.imdb.com/title/tt0480025/,https://m.media-amazon.com/images/M/MV5BMmE3OWZhZDYtOTBjMi00NDIwLTg1NWMtMjg0NjJmZWM4MjliL2ltYWdlXkEyXkFqcGdeQXVyNTAyODkwOQ@@._V1_.jpg,"Crime, Drama"
780,Ex Machina,711,1132,-421,https://www.imdb.com/title/tt0470752/,https://m.media-amazon.com/images/M/MV5BMTUxNzc0OTIxMV5BMl5BanBnXkFtZTgwNDI3NzU2NDE@._V1_.jpg,"Drama, Sci-Fi, Thriller"
782,The Last King of Scotland,808,686,122,https://www.imdb.com/title/tt0455590/,https://m.media-amazon.com/images/M/MV5BYzZkNjNhN2QtMThmNC00YjE0LTg0ZmMtMmU5MWE4Y2NjN2RiXkEyXkFqcGdeQXVyMTUzMDUzNTI3._V1_.jpg,"Biography, Drama, History"
783,Zodiac,832,1343,-511,https://www.imdb.com/title/tt0443706/,https://m.media-amazon.com/images/M/MV5BN2UwNDc5NmEtNjVjZS00OTI5LWE5YjctMWM3ZjBiZGYwMGI2XkEyXkFqcGdeQXVyNzkwMjQ5NzM@._V1_.jpg,"Crime, Drama, Mystery"
784,Lucky Number Slevin,792,683,109,https://www.imdb.com/title/tt0425210/,https://m.media-amazon.com/images/M/MV5BZjczMWI1YWMtYTZjOS00ZDc5LWE2MWItMTY3ZGUxNzFkNjJmL2ltYWdlXkEyXkFqcGdeQXVyNjU0OTQ0OTY@._V1_.jpg,"Crime, Drama, Thriller"
787,Tangled,960,297,663,https://www.imdb.com/title/tt0398286/,https://m.media-amazon.com/images/M/MV5BMTAxNDYxMjg0MjNeQTJeQWpwZ15BbWU3MDcyNTk2OTM@._V1_.jpg,"Animation, Adventure, Comedy"
789,Brokeback Mountain,1071,553,518,https://www.imdb.com/title/tt0388795/,https://m.media-amazon.com/images/M/MV5BNTM4NTFiZGMtNjljZi00MDIzLWJkNTctMzA0NWViNjYxMDY1XkEyXkFqcGdeQXVyMTU3NDU4MDg2._V1_.jpg,"Drama, Romance"
790,3:10 to Yuma,803,842,-39,https://www.imdb.com/title/tt0381849/,https://m.media-amazon.com/images/M/MV5BODE0NTcxNTQzNF5BMl5BanBnXkFtZTcwMzczOTIzMw@@._V1_.jpg,"Action, Crime, Drama"
791,Crash,679,721,-42,https://www.imdb.com/title/tt0375679/,https://m.media-amazon.com/images/M/MV5BOTk1OTA1MjIyNV5BMl5BanBnXkFtZTcwODQxMTkyMQ@@._V1_.jpg,"Crime, Drama, Thriller"
792,Kung Fu Hustle,725,745,-20,https://www.imdb.com/title/tt0373074/,https://m.media-amazon.com/images/M/MV5BMjZiOTNlMzYtZWYwZS00YWJjLTk5NDgtODkwNjRhMDI0MjhjXkEyXkFqcGdeQXVyMjgyNjk3MzE@._V1_.jpg,"Action, Comedy, Fantasy"
793,The Bourne Supremacy,744,953,-209,https://www.imdb.com/title/tt0372183/,https://m.media-amazon.com/images/M/MV5BYTIyMDFmMmItMWQzYy00MjBiLTg2M2UtM2JiNDRhOWE4NjBhXkEyXkFqcGdeQXVyNjU0OTQ0OTY@._V1_.jpg,"Action, Mystery, Thriller"
794,The Machinist,814,841,-27,https://www.imdb.com/title/tt0361862/,https://m.media-amazon.com/images/M/MV5BNjk1NzBlY2YtNjJmNi00YTVmLWI2OTgtNDUxNDE5NjUzZmE0XkEyXkFqcGdeQXVyNTc1NTQxODI@._V1_.jpg,"Drama, Thriller"
795,Ray,785,801,-16,https://www.imdb.com/title/tt0350258/,https://m.media-amazon.com/images/M/MV5BMTQxNDQwNjQzOV5BMl5BanBnXkFtZTcwNTQxNDYyMQ@@._V1_.jpg,"Biography, Drama, Music"
796,Lost in Translation,664,1462,-798,https://www.imdb.com/title/tt0335266/,https://m.media-amazon.com/images/M/MV5BMTUxMzk0NDg1MV5BMl5BanBnXkFtZTgwNDg0NjkxMDI@._V1_.jpg,"Comedy, Drama"
797,Harry Potter and the Goblet of Fire,1130,361,769,https://www.imdb.com/title/tt0330373/,https://m.media-amazon.com/images/M/MV5BMTI1NDMyMjExOF5BMl5BanBnXkFtZTcwOTc4MjQzMQ@@._V1_.jpg,"Adventure, Family, Fantasy"
798,Man on Fire,828,804,24,https://www.imdb.com/title/tt0328107/,https://m.media-amazon.com/images/M/MV5BODFlMmEwMDgtYjhmZi00ZTE5LTk2NWQtMWE1Y2M0NjkzOGYxXkEyXkFqcGdeQXVyNjU0OTQ0OTY@._V1_.jpg,"Action, Crime, Drama"
799,Coraline,883,747,136,https://www.imdb.com/title/tt0327597/,https://m.media-amazon.com/images/M/MV5BMzQxNjM5NzkxNV5BMl5BanBnXkFtZTcwMzg5NDMwMg@@._V1_.jpg,"Animation, Drama, Family"
800,The Last Samurai,728,1289,-561,https://www.imdb.com/title/tt0325710/,https://m.media-amazon.com/images/M/MV5BMzkyNzQ1Mzc0NV5BMl5BanBnXkFtZTcwODg3MzUzMw@@._V1_.jpg,"Action, Drama"
802,Good Bye Lenin!,807,551,256,https://www.imdb.com/title/tt0301357/,https://m.media-amazon.com/images/M/MV5BNzE3YzgzNDgtYmFiMC00ZTIxLTlhNDktMWYwNzFiMTk3NmM0XkEyXkFqcGdeQXVyMTU3NDU4MDg2._V1_.jpg,"Comedy, Drama, Romance"
804,I Am Sam,1116,488,628,https://www.imdb.com/title/tt0277027/,https://m.media-amazon.com/images/M/MV5BYzk5YTdmMzMtMjcyZS00ZDI4LThkMWItZDgwMzI0MzQyNDVjXkEyXkFqcGdeQXVyNjk1Njg5NTA@._V1_.jpg,Drama
805,Adaptation.,817,1626,-809,https://www.imdb.com/title/tt0268126/,https://m.media-amazon.com/images/M/MV5BN2JjNzVhOTMtNTc3Yi00NGNjLWI3YjgtYjkyZTYzY2FmMmIxXkEyXkFqcGdeQXVyMjUzOTY1NTc@._V1_.jpg,"Comedy, Drama"
806,Black Hawk Down,748,1330,-582,https://www.imdb.com/title/tt0265086/,https://m.media-amazon.com/images/M/MV5BYWMwMzQxZjQtODM1YS00YmFiLTk1YjQtNzNiYWY1MDE4NTdiXkEyXkFqcGdeQXVyNDYyMDk5MTU@._V1_.jpg,"Action, Drama, History"
807,Road to Perdition,815,1205,-390,https://www.imdb.com/title/tt0257044/,https://m.media-amazon.com/images/M/MV5BNjcxMmQ0MmItYTkzYy00MmUyLTlhOTQtMmJmNjE3MDMwYjdlXkEyXkFqcGdeQXVyNzkwMjQ5NzM@._V1_.jpg,"Crime, Drama, Thriller"
809,Billy Elliot,1028,375,653,https://www.imdb.com/title/tt0249462/,https://m.media-amazon.com/images/M/MV5BNGY3NWYwNzctNWU5Yi00ZjljLTgyNDgtZjNhZjRlNjc0ZTU1XkEyXkFqcGdeQXVyMTQxNzMzNDI@._V1_.jpg,"Drama, Music"
811,Ocean's Eleven,649,852,-203,https://www.imdb.com/title/tt0240772/,https://m.media-amazon.com/images/M/MV5BYzVmYzVkMmUtOGRhMi00MTNmLThlMmUtZTljYjlkMjNkMjJkXkEyXkFqcGdeQXVyNDk3NzU2MTQ@._V1_.jpg,"Crime, Thriller"
813,"O Brother, Where Art Thou?",774,829,-55,https://www.imdb.com/title/tt0190590/,https://m.media-amazon.com/images/M/MV5BMjZkOTdmMWItOTkyNy00MDdjLTlhNTQtYzU3MzdhZjA0ZDEyXkEyXkFqcGdeQXVyMTMxODk2OTU@._V1_.jpg,"Comedy, Crime, Drama"
815,"South Park: Bigger, Longer & Uncut",680,1516,-836,https://www.imdb.com/title/tt0158983/,https://m.media-amazon.com/images/M/MV5BOGE0ZWI0YzAtY2NkZi00YjkyLWIzYWEtNTJmMzJjODllNjdjXkEyXkFqcGdeQXVyMTQxNzMzNDI@._V1_.jpg,"Animation, Comedy, Fantasy"
816,Office Space,721,1263,-542,https://www.imdb.com/title/tt0151804/,https://m.media-amazon.com/images/M/MV5BOTA5MzQ3MzI1NV5BMl5BanBnXkFtZTgwNTcxNTYxMTE@._V1_.jpg,Comedy
818,Training Day,651,1436,-785,https://www.imdb.com/title/tt0139654/,https://m.media-amazon.com/images/M/MV5BMDZkMTUxYWEtMDY5NS00ZTA5LTg3MTItNTlkZWE1YWRjYjMwL2ltYWdlL2ltYWdlXkEyXkFqcGdeQXVyMTQxNzMzNDI@._V1_.jpg,"Crime, Drama, Thriller"
819,Rushmore,836,1282,-446,https://www.imdb.com/title/tt0128445/,https://m.media-amazon.com/images/M/MV5BODVhNjAzM2EtMzcyMi00YzA2LWIzMTEtNDYyZTk4MWU4YjBjXkEyXkFqcGdeQXVyNjk1Njg5NTA@._V1_.jpg,"Comedy, Drama, Romance"
821,Being John Malkovich,790,1097,-307,https://www.imdb.com/title/tt0120601/,https://m.media-amazon.com/images/M/MV5BMTFlYjgyMjUtNmJhZS00MDY2LTg0ZmMtNTVlNDA2NTUwYTRjXkEyXkFqcGdeQXVyMTUzMDUzNTI3._V1_.jpg,"Comedy, Drama, Fantasy"
822,As Good as It Gets,777,974,-197,https://www.imdb.com/title/tt0119822/,https://m.media-amazon.com/images/M/MV5BNWMxZTgzMWEtMTU0Zi00NDc5LWFkZjctMzUxNDIyNzZiMmNjXkEyXkFqcGdeQXVyMTQxNzMzNDI@._V1_.jpg,"Comedy, Drama, Romance"
823,The Fifth Element,843,575,268,https://www.imdb.com/title/tt0119116/,https://m.media-amazon.com/images/M/MV5BZWFjYmZmZGQtYzg4YS00ZGE5LTgwYzAtZmQwZjQ2NDliMGVmXkEyXkFqcGdeQXVyNTUyMzE4Mzg@._V1_.jpg,"Action, Adventure, Sci-Fi"
825,Donnie Brasco,660,1016,-356,https://www.imdb.com/title/tt0119008/,https://m.media-amazon.com/images/M/MV5BYzMzMDZkYWEtODIzNS00YjI3LTkxNTktOWEyZGM3ZWI2MWM4XkEyXkFqcGdeQXVyNzkwMjQ5NzM@._V1_.jpg,"Biography, Crime, Drama"
827,Primal Fear,899,597,302,https://www.imdb.com/title/tt0117381/,https://m.media-amazon.com/images/M/MV5BZTM2NWI2OGYtYWNhMi00ZTlmLTg2ZTAtMmI5NWRjODA5YTE1XkEyXkFqcGdeQXVyODE2OTYwNTg@._V1_.jpg,"Crime, Drama, Mystery"
832,Clerks,669,1283,-614,https://www.imdb.com/title/tt0109445/,https://m.media-amazon.com/images/M/MV5BNzE1Njk0NmItNDhlMC00ZmFlLWI4ZTUtYTY4ZjgzNjkyMTU1XkEyXkFqcGdeQXVyMTQxNzMzNDI@._V1_.jpg,Comedy
834,Philadelphia,844,401,443,https://www.imdb.com/title/tt0107818/,https://m.media-amazon.com/images/M/MV5BNDE0MWE1ZTMtOWFkMS00YjdiLTkwZTItMDljYjY3MjM0NTk5XkEyXkFqcGdeQXVyNDYyMDk5MTU@._V1_.jpg,Drama
838,The Last of the Mohicans,791,776,15,https://www.imdb.com/title/tt0104691/,https://m.media-amazon.com/images/M/MV5BZDNiYmRkNDYtOWU1NC00NmMxLWFkNmUtMGI5NTJjOTJmYTM5XkEyXkFqcGdeQXVyNzQ1ODk3MTQ@._V1_.jpg,"Action, Adventure, Drama"
841,A Few Good Men,888,957,-69,https://www.imdb.com/title/tt0104257/,https://m.media-amazon.com/images/M/MV5BMmRlZDQ1MmUtMzE2Yi00YTkxLTk1MGMtYmIyYWQwODcxYzRlXkEyXkFqcGdeQXVyNTI4MjkwNjA@._V1_.jpg,"Drama, Thriller"
843,Barton Fink,802,1288,-486,https://www.imdb.com/title/tt0101410/,https://m.media-amazon.com/images/M/MV5BMTgxMDMxMTctNDY0Zi00ZmNlLWFlYmQtODA2YjY4MDk4MjU1XkEyXkFqcGdeQXVyNTc1NTQxODI@._V1_.jpg,"Comedy, Drama, Thriller"
844,Miller's Crossing,634,1191,-557,https://www.imdb.com/title/tt0100150/,https://m.media-amazon.com/images/M/MV5BMTY2Njk3MTAzM15BMl5BanBnXkFtZTgwMTY5Mzk4NjE@._V1_.jpg,"Crime, Drama, Thriller"
845,Who Framed Roger Rabbit,846,1043,-197,https://www.imdb.com/title/tt0096438/,https://m.media-amazon.com/images/M/MV5BMDhiOTM2OTctODk3Ny00NWI4LThhZDgtNGQ4NjRiYjFkZGQzXkEyXkFqcGdeQXVyMTA0MjU0Ng@@._V1_.jpg,"Animation, Adventure, Comedy"
849,Empire of the Sun,798,402,396,https://www.imdb.com/title/tt0092965/,https://m.media-amazon.com/images/M/MV5BMmQwNzczZDItNmI0OS00MjRmLTliYWItZWIyMjk1MTU4ZTQ4L2ltYWdlXkEyXkFqcGdeQXVyNTAyODkwOQ@@._V1_.jpg,"Drama, War"
850,The Name of the Rose,700,1010,-310,https://www.imdb.com/title/tt0091605/,https://m.media-amazon.com/images/M/MV5BZjEyZTdhNDMtMWFkMS00ZmRjLWEyNmEtZDU3MWFkNDEzMDYwXkEyXkFqcGdeQXVyNjc1NTYyMjg@._V1_.jpg,"Drama, Mystery, Thriller"
851,Blue Velvet,720,1414,-694,https://www.imdb.com/title/tt0090756/,https://m.media-amazon.com/images/M/MV5BMzExOTczNTgtN2Q1Yy00MmI1LWE0NjgtNmIwMzdmZGNlODU1XkEyXkFqcGdeQXVyNDkzNTM2ODg@._V1_.jpg,"Crime, Drama, Mystery"
856,Star Trek II: The Wrath of Khan,799,1052,-253,https://www.imdb.com/title/tt0084726/,https://m.media-amazon.com/images/M/MV5BNmZiZmM2OTUtZDlmOC00YzYyLThkMGEtZWFkMjJmM2EwZDVkXkEyXkFqcGdeQXVyMjUzOTY1NTc@._V1_.jpg,"Action, Adventure, Sci-Fi"
857,First Blood,775,1842,-1067,https://www.imdb.com/title/tt0083944/,https://m.media-amazon.com/images/M/MV5BODBmOWU2YWMtZGUzZi00YzRhLWJjNDAtYTUwNWVkNDcyZmU5XkEyXkFqcGdeQXVyNDk3NzU2MTQ@._V1_.jpg,"Action, Adventure, Thriller"
859,Airplane!,659,1377,-718,https://www.imdb.com/title/tt0080339/,https://m.media-amazon.com/images/M/MV5BZjA3YjdhMWEtYjc2Ni00YzVlLWI0MTUtMGZmNTJjNmU0Yzk2XkEyXkFqcGdeQXVyNzkwMjQ5NzM@._V1_.jpg,Comedy
861,Halloween,710,1216,-506,https://www.imdb.com/title/tt0077651/,https://m.media-amazon.com/images/M/MV5BNzk1OGU2NmMtNTdhZC00NjdlLWE5YTMtZTQ0MGExZTQzOGQyXkEyXkFqcGdeQXVyMTQxNzMzNDI@._V1_.jpg,"Horror, Thriller"
865,Blazing Saddles,760,782,-22,https://www.imdb.com/title/tt0071230/,https://m.media-amazon.com/images/M/MV5BZGZmMWE1MDYtNzAyNC00MDMzLTgzZjQtNTQ5NjYzN2E4MzkzXkEyXkFqcGdeQXVyNDk3NzU2MTQ@._V1_.jpg,"Comedy, Western"
866,Serpico,750,819,-69,https://www.imdb.com/title/tt0070666/,https://m.media-amazon.com/images/M/MV5BOTRkNjg3YzQtNGE3NC00M2U1LTg1ODItNmM3ZjMyOTYzYjEwXkEyXkFqcGdeQXVyMjUzOTY1NTc@._V1_.jpg,"Biography, Crime, Drama"
869,The French Connection,749,1482,-733,https://www.imdb.com/title/tt0067116/,https://m.media-amazon.com/images/M/MV5BOTZhY2E3NmItMGIwNi00OTA2LThkYmEtODFiZTM0NGI0ZWU5XkEyXkFqcGdeQXVyNTc1NTQxODI@._V1_.jpg,"Action, Crime, Drama"
870,Dirty Harry,658,1270,-612,https://www.imdb.com/title/tt0066999/,https://m.media-amazon.com/images/M/MV5BMzdhMTM2YTItOWU2YS00MTM0LTgyNDYtMDM1OWM3NzkzNTM2XkEyXkFqcGdeQXVyNjc1NTYyMjg@._V1_.jpg,"Action, Crime, Thriller"
878,Goldfinger,707,1643,-936,https://www.imdb.com/title/tt0058150/,https://m.media-amazon.com/images/M/MV5BMTQ2MzE0OTU3NV5BMl5BanBnXkFtZTcwNjQxNTgzNA@@._V1_.jpg,"Action, Adventure, Thriller"
879,The Birds,842,845,-3,https://www.imdb.com/title/tt0056869/,https://m.media-amazon.com/images/M/MV5BMTAxNDA1ODc5MDleQTJeQWpwZ15BbWU4MDg2MDA4OTEx._V1_.jpg,"Drama, Horror, Mystery"
898,The Two Popes,1097,919,178,https://www.imdb.com/title/tt8404614/,https://m.media-amazon.com/images/M/MV5BY2RiOTc1YmYtMDk0Yy00ZWI4LTgzN2YtYTg2ZDZmOGIwNTA1XkEyXkFqcGdeQXVyMTMxODk2OTU@._V1_.jpg,"Biography, Comedy, Drama"
900,Searching,1003,930,73,https://www.imdb.com/title/tt7668870/,https://m.media-amazon.com/images/M/MV5BZjk5Yjk0MzYtZTVlMC00OWJjLThjZTEtZGIyY2U3OTc2ODg4XkEyXkFqcGdeQXVyODQxMTI4MjM@._V1_.jpg,"Drama, Mystery, Thriller"
903,Once Upon a Time... In Hollywood,919,1475,-556,https://www.imdb.com/title/tt7131622/,https://m.media-amazon.com/images/M/MV5BOTg4ZTNkZmUtMzNlZi00YmFjLTk1MmUtNWQwNTM0YjcyNTNkXkEyXkFqcGdeQXVyNjg2NjQwMDQ@._V1_.jpg,"Comedy, Drama"
908,Train to Busan,1158,691,467,https://www.imdb.com/title/tt5700672/,https://m.media-amazon.com/images/M/MV5BMTkwOTQ4OTg0OV5BMl5BanBnXkFtZTgwMzQyOTM0OTE@._V1_.jpg,"Action, Horror, Thriller"
911,"Love, Simon",1289,860,429,https://www.imdb.com/title/tt5164432/,https://m.media-amazon.com/images/M/MV5BNTMyZDdiMzUtZjcxNS00Mjc3LTljY2UtYjI4YmY5NzJlYjc1XkEyXkFqcGdeQXVyMTA5OTkwNTc@._V1_.jpg,"Comedy, Drama"
913,Gifted,1018,815,203,https://www.imdb.com/title/tt4481414/,https://m.media-amazon.com/images/M/MV5BMjQ2NDU3NDE0M15BMl5BanBnXkFtZTgwMjA3OTg0MDI@._V1_.jpg,Drama
917,Guardians of the Galaxy Vol. 2,1068,660,408,https://www.imdb.com/title/tt3896198/,https://m.media-amazon.com/images/M/MV5BNjM0NTc0NzItM2FlYS00YzEwLWE0YmUtNTA2ZWIzODc2OTgxXkEyXkFqcGdeQXVyNTgwNzIyNzg@._V1_.jpg,"Action, Adventure, Comedy"
918,Baby Driver,1080,1227,-147,https://www.imdb.com/title/tt3890160/,https://m.media-amazon.com/images/M/MV5BMjM3MjQ1MzkxNl5BMl5BanBnXkFtZTgwODk1ODgyMjI@._V1_.jpg,"Action, Crime, Drama"
921,Bridge of Spies,995,1138,-143,https://www.imdb.com/title/tt3682448/,https://m.media-amazon.com/images/M/MV5BMjIxOTI0MjU5NV5BMl5BanBnXkFtZTgwNzM4OTk4NTE@._V1_.jpg,"Drama, History, Thriller"
922,Incredibles 2,981,743,238,https://www.imdb.com/title/tt3606756/,https://m.media-amazon.com/images/M/MV5BMTEzNzY0OTg0NTdeQTJeQWpwZ15BbWU4MDU3OTg3MjUz._V1_.jpg,"Animation, Action, Adventure"
923,Moana,1163,517,646,https://www.imdb.com/title/tt3521164/,https://m.media-amazon.com/images/M/MV5BMjI4MzU5NTExNF5BMl5BanBnXkFtZTgwNzY1MTEwMDI@._V1_.jpg,"Animation, Adventure, Comedy"
924,Sicario,855,1711,-856,https://www.imdb.com/title/tt3397884/,https://m.media-amazon.com/images/M/MV5BMjA5NjM3NTk1M15BMl5BanBnXkFtZTgwMzg1MzU2NjE@._V1_.jpg,"Action, Crime, Drama"
925,Creed,1008,1265,-257,https://www.imdb.com/title/tt3076658/,https://m.media-amazon.com/images/M/MV5BNmZkYjQzY2QtNjdkNC00YjkzLTk5NjUtY2MyNDNiYTBhN2M2XkEyXkFqcGdeQXVyMjMwNDgzNjc@._V1_.jpg,"Action, Drama, Sport"
928,Fury,972,1268,-296,https://www.imdb.com/title/tt2713180/,https://m.media-amazon.com/images/M/MV5BMjA4MDU0NTUyN15BMl5BanBnXkFtZTgwMzQxMzY4MjE@._V1_.jpg,"Action, Drama, War"
929,Hell or High Water,858,1486,-628,https://www.imdb.com/title/tt2582782/,https://m.media-amazon.com/images/M/MV5BMTg4NDA1OTA5NF5BMl5BanBnXkFtZTgwMDQ2MDM5ODE@._V1_.jpg,"Crime, Drama, Thriller"
933,Dawn of the Planet of the Apes,989,1318,-329,https://www.imdb.com/title/tt2103281/,https://m.media-amazon.com/images/M/MV5BYWE2MzU2ZGUtYTY1Yi00ZTI5LWE4NzMtNWM1NzRhMDQ3ZjM3XkEyXkFqcGdeQXVyNjc5NjEzNA@@._V1_.jpg,"Action, Adventure, Drama"
936,The Raid: Redemption,913,1438,-525,https://www.imdb.com/title/tt1899353/,https://m.media-amazon.com/images/M/MV5BY2UyNDM1ZmUtM2E4Mi00ZDEzLWFhMTEtOGVlYjQ2NDZiYjg3XkEyXkFqcGdeQXVyNzI1NzMxNzM@._V1_.jpg,"Action, Crime, Thriller"
937,End of Watch,904,1123,-219,https://www.imdb.com/title/tt1855199/,https://m.media-amazon.com/images/M/MV5BMjMxNjU0ODU5Ml5BMl5BanBnXkFtZTcwNjI4MzAyOA@@._V1_.jpg,"Action, Crime, Drama"
939,Les Misérables,1236,635,601,https://www.imdb.com/title/tt1707386/,https://m.media-amazon.com/images/M/MV5BNWZhNGM1ZTItYTg4Zi00MTE2LTg5MjYtYjdmYmZkNTVmYTQwXkEyXkFqcGdeQXVyMTMxODk2OTU@._V1_.jpg,"Drama, Musical, Romance"
940,The Impossible,1234,532,702,https://www.imdb.com/title/tt1649419/,https://m.media-amazon.com/images/M/MV5BMWFjZDVjYjMtZWIyMS00MTkwLWI1OWMtMzNmZjgzMGVlODM4XkEyXkFqcGdeQXVyNzYxNjU1ODQ@._V1_.jpg,"Drama, History, Thriller"
942,A Star Is Born,950,867,83,https://www.imdb.com/title/tt1517451/,https://m.media-amazon.com/images/M/MV5BNmE5ZmE3OGItNTdlNC00YmMxLWEzNjctYzAwOGQ5ODg0OTI0XkEyXkFqcGdeQXVyMTMxODk2OTU@._V1_.jpg,"Drama, Music, Romance"
943,The Greatest Showman,1329,568,761,https://www.imdb.com/title/tt1485796/,https://m.media-amazon.com/images/M/MV5BMjI1NDYzNzY2Ml5BMl5BanBnXkFtZTgwODQwODczNTM@._V1_.jpg,"Biography, Drama, Musical"
947,True Grit,903,1244,-341,https://www.imdb.com/title/tt1403865/,https://m.media-amazon.com/images/M/MV5BMTU5MjU3MTI4OF5BMl5BanBnXkFtZTcwMTQxOTAxNA@@._V1_.jpg,"Drama, Western"
950,Despicable Me,1074,516,558,https://www.imdb.com/title/tt1323594/,https://m.media-amazon.com/images/M/MV5BMTY3NjY0MTQ0Nl5BMl5BanBnXkFtZTcwMzQ2MTc0Mw@@._V1_.jpg,"Animation, Adventure, Comedy"
951,Rise of the Planet of the Apes,1110,1200,-90,https://www.imdb.com/title/tt1318514/,https://m.media-amazon.com/images/M/MV5BZjI5MzM3NmEtZDk5Zi00YWY4LTgzZmMtZDJjMmNlOTQ1ZTY4XkEyXkFqcGdeQXVyNTIzOTk5ODM@._V1_.jpg,"Action, Drama, Sci-Fi"
952,A Single Man,1267,663,604,https://www.imdb.com/title/tt1315981/,https://m.media-amazon.com/images/M/MV5BMzU5MTk4MjQ2M15BMl5BanBnXkFtZTcwNDU0MzEwMw@@._V1_.jpg,"Crime, Drama, Romance"
953,50/50,878,998,-120,https://www.imdb.com/title/tt1306980/,https://m.media-amazon.com/images/M/MV5BNjg3ODQyNTIyN15BMl5BanBnXkFtZTcwMjUzNzM5NQ@@._V1_.jpg,"Comedy, Drama, Romance"
954,Kick-Ass,840,1465,-625,https://www.imdb.com/title/tt1250777/,https://m.media-amazon.com/images/M/MV5BMTMzNzEzMDYxM15BMl5BanBnXkFtZTcwMTc0NTMxMw@@._V1_.jpg,"Action, Comedy, Crime"
956,Moneyball,881,1717,-836,https://www.imdb.com/title/tt1210166/,https://m.media-amazon.com/images/M/MV5BMjAxOTU3Mzc1M15BMl5BanBnXkFtZTcwMzk1ODUzNg@@._V1_.jpg,"Biography, Drama, Sport"
958,The Skin I Live In,951,803,148,https://www.imdb.com/title/tt1189073/,https://m.media-amazon.com/images/M/MV5BYmFmNjY5NDYtZjlhNi00YjQ5LTgzNzctNWRiNWUzNmIyNjc4XkEyXkFqcGdeQXVyMTMxODk2OTU@._V1_.jpg,"Drama, Mystery, Thriller"
959,Zombieland,978,1054,-76,https://www.imdb.com/title/tt1156398/,https://m.media-amazon.com/images/M/MV5BMTU5MDg0NTQ1N15BMl5BanBnXkFtZTcwMjA4Mjg3Mg@@._V1_.jpg,"Action, Comedy, Horror"
962,The Wave,973,715,258,https://www.imdb.com/title/tt1063669/,https://m.media-amazon.com/images/M/MV5BZmFhNmJkMjMtYTYyOC00MTM0LThjNWEtZWU2MjY0NTU0MmVhXkEyXkFqcGdeQXVyNzI1NzMxNzM@._V1_.jpg,"Drama, Thriller"
964,Sherlock Holmes,1016,892,124,https://www.imdb.com/title/tt0988045/,https://m.media-amazon.com/images/M/MV5BMTg0NjEwNjUxM15BMl5BanBnXkFtZTcwMzk0MjQ5Mg@@._V1_.jpg,"Action, Adventure, Mystery"
967,The Reader,1095,689,406,https://www.imdb.com/title/tt0976051/,https://m.media-amazon.com/images/M/MV5BMTM0NDQxNjA0N15BMl5BanBnXkFtZTcwNDUwMzcwMg@@._V1_.jpg,"Drama, Mystery, Romance"
968,The Blind Side,1078,458,620,https://www.imdb.com/title/tt0878804/,https://m.media-amazon.com/images/M/MV5BMjEzOTE3ODM3OF5BMl5BanBnXkFtZTcwMzYyODI4Mg@@._V1_.jpg,"Biography, Drama, Sport"
970,Superbad,964,1856,-892,https://www.imdb.com/title/tt0829482/,https://m.media-amazon.com/images/M/MV5BY2VkMDg4ZTYtN2M3Yy00NWZiLWE2ODEtZjU5MjZkYWNkNGIzXkEyXkFqcGdeQXVyODY5Njk4Njc@._V1_.jpg,Comedy
971,The Book Thief,1309,529,780,https://www.imdb.com/title/tt0816442/,https://m.media-amazon.com/images/M/MV5BOTE3NzkyMjAyNF5BMl5BanBnXkFtZTgwMDc5MTE0MDE@._V1_.jpg,"Drama, War"
972,Seven Pounds,959,793,166,https://www.imdb.com/title/tt0814314/,https://m.media-amazon.com/images/M/MV5BMTU0NzY0MTY5OF5BMl5BanBnXkFtZTcwODY3MDEwMg@@._V1_.jpg,"Drama, Mystery, Thriller"
974,Eastern Promises,946,992,-46,https://www.imdb.com/title/tt0765443/,https://m.media-amazon.com/images/M/MV5BMTcwMzU0OTY3NF5BMl5BanBnXkFtZTYwNzkwNjg2._V1_.jpg,"Crime, Drama, Thriller"
975,Stardust,1026,737,289,https://www.imdb.com/title/tt0486655/,https://m.media-amazon.com/images/M/MV5BMjkyMTE1OTYwNF5BMl5BanBnXkFtZTcwMDIxODYzMw@@._V1_.jpg,"Adventure, Family, Fantasy"
979,Inside Man,930,1236,-306,https://www.imdb.com/title/tt0454848/,https://m.media-amazon.com/images/M/MV5BYjc4MjA2ZDgtOGY3YS00NDYzLTlmNTEtYWMxMzcwZjgzYWNjXkEyXkFqcGdeQXVyMTQxNzMzNDI@._V1_.jpg,"Crime, Drama, Mystery"
980,Gone Baby Gone,932,1241,-309,https://www.imdb.com/title/tt0452623/,https://m.media-amazon.com/images/M/MV5BYmM2NDNiNGItMTRhMi00ZDA2LTgzOWMtZTE2ZjFhMDQ2M2U5XkEyXkFqcGdeQXVyNTAyODkwOQ@@._V1_.jpg,"Crime, Drama, Mystery"
985,The Illusionist,923,958,-35,https://www.imdb.com/title/tt0443543/,https://m.media-amazon.com/images/M/MV5BY2VkMzZlZDAtNTkzNS00MDIzLWFmOTctMWQwZjQ1OWJiYzQ1XkEyXkFqcGdeQXVyNTIzOTk5ODM@._V1_.jpg,"Drama, Fantasy, Mystery"
987,Kung Fu Panda,970,1466,-496,https://www.imdb.com/title/tt0441773/,https://m.media-amazon.com/images/M/MV5BODJkZTZhMWItMDI3Yy00ZWZlLTk4NjQtOTI1ZjU5NjBjZTVjXkEyXkFqcGdeQXVyODE5NzE3OTE@._V1_.jpg,"Animation, Action, Adventure"
988,Thank You for Smoking,986,1495,-509,https://www.imdb.com/title/tt0427944/,https://m.media-amazon.com/images/M/MV5BMTI2MDk5MjE4NV5BMl5BanBnXkFtZTYwMjkwNTU3._V1_.jpg,"Comedy, Drama"
992,Harry Potter and the Half-Blood Prince,1336,417,919,https://www.imdb.com/title/tt0417741/,https://m.media-amazon.com/images/M/MV5BNzU3NDg4NTAyNV5BMl5BanBnXkFtZTcwOTg2ODg1Mg@@._V1_.jpg,"Action, Adventure, Family"
993,300,853,1365,-512,https://www.imdb.com/title/tt0416449/,https://m.media-amazon.com/images/M/MV5BMjc4OTc0ODgwNV5BMl5BanBnXkFtZTcwNjM1ODE0MQ@@._V1_.jpg,"Action, Drama"
994,Match Point,839,1293,-454,https://www.imdb.com/title/tt0416320/,https://m.media-amazon.com/images/M/MV5BMTQ1NzQ4OTM4MV5BMl5BanBnXkFtZTcwNzY2OTQzMw@@._V1_.jpg,"Drama, Romance, Thriller"
995,Watchmen,789,1843,-1054,https://www.imdb.com/title/tt0409459/,https://m.media-amazon.com/images/M/MV5BY2IzNGNiODgtOWYzOS00OTI0LTgxZTUtOTA5OTQ5YmI3NGUzXkEyXkFqcGdeQXVyNjU0OTQ0OTY@._V1_.jpg,"Action, Drama, Mystery"
996,Lord of War,998,1476,-478,https://www.imdb.com/title/tt0399295/,https://m.media-amazon.com/images/M/MV5BMTYzZWE3MDAtZjZkMi00MzhlLTlhZDUtNmI2Zjg3OWVlZWI0XkEyXkFqcGdeQXVyNDk3NzU2MTQ@._V1_.jpg,"Crime, Drama"
997,Saw,882,1306,-424,https://www.imdb.com/title/tt0387564/,https://m.media-amazon.com/images/M/MV5BM2M1MzI1MWYtYmM2ZC00OWY3LTk0ZGMtNmRkNzU1NzEzMWE5XkEyXkFqcGdeQXVyODUwOTkwODk@._V1_.jpg,"Horror, Mystery, Thriller"
1004,21 Grams,831,771,60,https://www.imdb.com/title/tt0315733/,https://m.media-amazon.com/images/M/MV5BMjA4MjI2OTM5N15BMl5BanBnXkFtZTcwNDA1NjUzMw@@._V1_.jpg,"Crime, Drama, Thriller"
1005,Love Actually,1186,627,559,https://www.imdb.com/title/tt0314331/,https://m.media-amazon.com/images/M/MV5BNThkNjgxNGQtOTIxMy00ZTFmLWIwMDItYzE5YzM3ZDMzNDE3XkEyXkFqcGdeQXVyMTUyNjc3NDQ4._V1_.jpg,"Comedy, Drama, Romance"
1007,Finding Neverland,947,632,315,https://www.imdb.com/title/tt0308644/,https://m.media-amazon.com/images/M/MV5BNTVmZWE4NGItZmI3Ny00Nzk3LWIyMzQtOTBlYjc4Y2MzMWNjXkEyXkFqcGdeQXVyNjc3MjQzNTI@._V1_.jpg,"Biography, Drama, Family"
1008,25th Hour,850,1094,-244,https://www.imdb.com/title/tt0307901/,https://m.media-amazon.com/images/M/MV5BNmE0YjdlYTktMTU4Ni00Mjk2LWI3NWMtM2RjNmFiOTk4YjYxL2ltYWdlXkEyXkFqcGdeQXVyNTAyODkwOQ@@._V1_.jpg,Drama
1009,The Life of David Gale,1162,538,624,https://www.imdb.com/title/tt0289992/,https://m.media-amazon.com/images/M/MV5BMTAxMzU0NTgxNzZeQTJeQWpwZ15BbWU2MDQzNDkxNw@@._V1_.jpg,"Crime, Drama, Mystery"
1010,The Butterfly Effect,818,987,-169,https://www.imdb.com/title/tt0289879/,https://m.media-amazon.com/images/M/MV5BODNiZmY2MWUtMjFhMy00ZmM2LTg2MjYtNWY1OTY5NGU2MjdjL2ltYWdlXkEyXkFqcGdeQXVyNTAyODkwOQ@@._V1_.jpg,"Drama, Sci-Fi, Thriller"
1011,28 Days Later...,1031,1150,-119,https://www.imdb.com/title/tt0289043/,https://m.media-amazon.com/images/M/MV5BYTFkM2ViMmQtZmI5NS00MjQ2LWEyN2EtMTI1ZmNlZDU3MTZjXkEyXkFqcGdeQXVyNjU0OTQ0OTY@._V1_.jpg,"Drama, Horror, Sci-Fi"
1012,Battle Royale,984,911,73,https://www.imdb.com/title/tt0266308/,https://m.media-amazon.com/images/M/MV5BMDc2MGYwYzAtNzE2Yi00YmU3LTkxMDUtODk2YjhiNDM5NDIyXkEyXkFqcGdeQXVyMTEwNDU1MzEy._V1_.jpg,"Action, Adventure, Drama"
1013,The Royal Tenenbaums,1041,907,134,https://www.imdb.com/title/tt0265666/,https://m.media-amazon.com/images/M/MV5BYmUzODQ5MGItZTZlNy00MDBhLWIxMmItMjg4Y2QyNDFlMWQ2XkEyXkFqcGdeQXVyMTMxODk2OTU@._V1_.jpg,"Comedy, Drama"
1014,Y Tu Mamá También,875,1269,-394,https://www.imdb.com/title/tt0245574/,https://m.media-amazon.com/images/M/MV5BNDhjMzc3ZTgtY2Y4MC00Y2U3LWFiMDctZGM3MmM4N2YzNDQ5XkEyXkFqcGdeQXVyMTQxNzMzNDI@._V1_.jpg,Drama
1015,Harry Potter and the Sorcerer's Stone,1363,253,1110,https://www.imdb.com/title/tt0241527/,https://m.media-amazon.com/images/M/MV5BNmQ0ODBhMjUtNDRhOC00MGQzLTk5MTAtZDliODg5NmU5MjZhXkEyXkFqcGdeQXVyNDUyOTg3Njg@._V1_.jpg,"Adventure, Family, Fantasy"
1017,The Others,1062,850,212,https://www.imdb.com/title/tt0230600/,https://m.media-amazon.com/images/M/MV5BYjVhMmM3ZTMtNzIzOS00YTY4LTkxNTAtOTA5Mjk3YzMwMzA2XkEyXkFqcGdeQXVyNDE0OTU3NDY@._V1_.jpg,"Horror, Mystery, Thriller"
1018,Blow,1012,1223,-211,https://www.imdb.com/title/tt0221027/,https://m.media-amazon.com/images/M/MV5BYjg5ZDkzZWEtZDQ2ZC00Y2ViLThhMzYtMmIxZDYzYTY2Y2Y2XkEyXkFqcGdeQXVyODAwMTU1MTE@._V1_.jpg,"Biography, Crime, Drama"
1019,Enemy at the Gates,934,1232,-298,https://www.imdb.com/title/tt0215750/,https://m.media-amazon.com/images/M/MV5BYWFlY2E3ODQtZWNiNi00ZGU4LTkzNWEtZTQ2ZTViMWRhYjIzL2ltYWdlXkEyXkFqcGdeQXVyNTAyODkwOQ@@._V1_.jpg,"Action, Drama, War"
1020,Moulin Rouge!,1364,533,831,https://www.imdb.com/title/tt0203009/,https://m.media-amazon.com/images/M/MV5BMWFhYjliNjYtYjNhNS00OGExLWFhMjQtNDgwOWYyNWJiYzhmXkEyXkFqcGdeQXVyMTMxODk2OTU@._V1_.jpg,"Drama, Musical, Romance"
1021,Traffic,979,1533,-554,https://www.imdb.com/title/tt0181865/,https://m.media-amazon.com/images/M/MV5BNDA2YjNkMjEtZjcwNy00ZTc5LWEzNDItMjE0ODlmMDAzNDFkXkEyXkFqcGdeQXVyMTMxODk2OTU@._V1_.jpg,"Crime, Drama, Thriller"
1022,Minority Report,935,1239,-304,https://www.imdb.com/title/tt0181689/,https://m.media-amazon.com/images/M/MV5BZTI3YzZjZjEtMDdjOC00OWVjLTk0YmYtYzI2MGMwZjFiMzBlXkEyXkFqcGdeQXVyMTQxNzMzNDI@._V1_.jpg,"Action, Crime, Mystery"
1026,American Psycho,968,1249,-281,https://www.imdb.com/title/tt0144084/,https://m.media-amazon.com/images/M/MV5BZTM2ZGJmNjQtN2UyOS00NjcxLWFjMDktMDE2NzMyNTZlZTBiXkEyXkFqcGdeQXVyNzkwMjQ5NzM@._V1_.jpg,"Crime, Drama, Horror"
1027,Run Lola Run,920,729,191,https://www.imdb.com/title/tt0130827/,https://m.media-amazon.com/images/M/MV5BMWJiNWI1MjgtNzk5NC00YjRiLTg2NDAtMjI1Mjg0ZjMwNzZlXkEyXkFqcGdeQXVyMTQyODg5MjQw._V1_.jpg,"Action, Crime, Thriller"
1028,The Thin Red Line,849,1207,-358,https://www.imdb.com/title/tt0120863/,https://m.media-amazon.com/images/M/MV5BYjEzMTM2NjAtNWFmZC00MTVlLTgyMmQtMGQyNTFjZDk5N2NmXkEyXkFqcGdeQXVyNzQ1ODk3MTQ@._V1_.jpg,"Drama, History, War"
1030,Mulan,1360,278,1082,https://www.imdb.com/title/tt0120762/,https://m.media-amazon.com/images/M/MV5BODkxNGQ1NWYtNzg0Ny00Yjg3LThmZTItMjE2YjhmZTQ0ODY5XkEyXkFqcGdeQXVyMTQxNzMzNDI@._V1_.jpg,"Animation, Adventure, Comedy"
1031,Fear and Loathing in Las Vegas,910,1426,-516,https://www.imdb.com/title/tt0120669/,https://m.media-amazon.com/images/M/MV5BY2RkY2M2N2QtZGY5ZS00YmVjLThmNTItY2ZkM2JlYmFhZWQyXkEyXkFqcGdeQXVyMjUzOTY1NTc@._V1_.jpg,"Adventure, Comedy, Drama"
1033,Dark City,848,1140,-292,https://www.imdb.com/title/tt0118929/,https://m.media-amazon.com/images/M/MV5BMGExOGExM2UtNWM5ZS00OWEzLTllNzYtM2NlMTJlYjBlZTJkXkEyXkFqcGdeQXVyMTQxNzMzNDI@._V1_.jpg,"Fantasy, Mystery, Sci-Fi"
1034,Star Trek: First Contact,1067,1000,67,https://www.imdb.com/title/tt0117731/,https://m.media-amazon.com/images/M/MV5BYzMzZmE3MTItODYzYy00YWI5LWFkNWMtZTY5NmU2MDkxYWI1XkEyXkFqcGdeQXVyMjUzOTY1NTc@._V1_.jpg,"Action, Adventure, Drama"
1035,Sleepers,1010,731,279,https://www.imdb.com/title/tt0117665/,https://m.media-amazon.com/images/M/MV5BMzk1MmI4NzAtOGRiNS00YjY1LTllNmEtZDhiZDM4MjU2NTMxXkEyXkFqcGdeQXVyNjc3MjQzNTI@._V1_.jpg,"Crime, Drama, Thriller"
1036,Lost Highway,983,1319,-336,https://www.imdb.com/title/tt0116922/,https://m.media-amazon.com/images/M/MV5BZDBmMjg0MWMtNTQ3MS00NGQ5LTg4YzQtNzA1NTk2MWQ2NzY3XkEyXkFqcGdeQXVyMjUzOTY1NTc@._V1_.jpg,"Drama, Mystery, Thriller"
1037,Sense and Sensibility,1347,554,793,https://www.imdb.com/title/tt0114388/,https://m.media-amazon.com/images/M/MV5BZTI1YmI0NTAtMjc4MS00MzE5LWJmYTgtOTVhZTA2NDVjYzczXkEyXkFqcGdeQXVyMTI5ODA1OTU0._V1_.jpg,"Drama, Romance"
1038,Die Hard with a Vengeance,905,1308,-403,https://www.imdb.com/title/tt0112864/,https://m.media-amazon.com/images/M/MV5BZjI0ZWFiMmQtMjRlZi00ZmFhLWI4NmYtMjQ5YmY0MzIyMzRiXkEyXkFqcGdeQXVyMTQxNzMzNDI@._V1_.jpg,"Action, Adventure, Thriller"
1041,Apollo 13,876,1030,-154,https://www.imdb.com/title/tt0112384/,https://m.media-amazon.com/images/M/MV5BMjc4MzZlNmQtN2ZlOS00OGQzLWI5YjEtNDQ2YmZlN2FjNTIxXkEyXkFqcGdeQXVyMjUzOTY1NTc@._V1_.jpg,"Adventure, Drama, History"
1044,Legends of the Fall,1211,836,375,https://www.imdb.com/title/tt0110322/,https://m.media-amazon.com/images/M/MV5BNzUwMzhkY2EtYzg4NC00NzZmLWEzNmItMDU4MmNlZTRjYzIxXkEyXkFqcGdeQXVyMTUzMDUzNTI3._V1_.jpg,"Drama, Romance, War"
1045,The Crow,1188,681,507,https://www.imdb.com/title/tt0109506/,https://m.media-amazon.com/images/M/MV5BOGIxYmFiMzQtZDQwMC00ZTAxLWIzZTQtOTM5MzJkZmJjZTJhXkEyXkFqcGdeQXVyMTUyNjc3NDQ4._V1_.jpg,"Action, Crime, Drama"
1049,Falling Down,975,1514,-539,https://www.imdb.com/title/tt0106856/,https://m.media-amazon.com/images/M/MV5BY2UyN2Y4MGYtOTFhYi00ZmExLTgyYjEtOTk3ZDRlOTQwODMxXkEyXkFqcGdeQXVyMTUzMDUzNTI3._V1_.jpg,"Action, Crime, Drama"
1050,Dazed and Confused,961,1515,-554,https://www.imdb.com/title/tt0106677/,https://m.media-amazon.com/images/M/MV5BMTM5MDY5MDQyOV5BMl5BanBnXkFtZTgwMzM3NzMxMDE@._V1_.jpg,Comedy
1051,My Cousin Vinny,1079,1051,28,https://www.imdb.com/title/tt0104952/,https://m.media-amazon.com/images/M/MV5BMTQxNDYzMTg1M15BMl5BanBnXkFtZTgwNzk4MDgxMTE@._V1_.jpg,"Comedy, Crime"
1056,The Hunt for Red October,1032,1370,-338,https://www.imdb.com/title/tt0099810/,https://m.media-amazon.com/images/M/MV5BZDdkODg3YzctMGVmZS00ZDM5LWIzNTctZDRlMjA5Mjc4MGViXkEyXkFqcGdeQXVyODE5NzE3OTE@._V1_.jpg,"Action, Adventure, Thriller"
1057,Home Alone,1057,886,171,https://www.imdb.com/title/tt0099785/,https://m.media-amazon.com/images/M/MV5BMzFkM2YwOTQtYzk2Mi00N2VlLWE3NTItN2YwNDg1YmY0ZDNmXkEyXkFqcGdeQXVyMTMxODk2OTU@._V1_.jpg,"Comedy, Family"
1058,The Godfather: Part III,957,1032,-75,https://www.imdb.com/title/tt0099674/,https://m.media-amazon.com/images/M/MV5BNWFlYWY2YjYtNjdhNi00MzVlLTg2MTMtMWExNzg4NmM5NmEzXkEyXkFqcGdeQXVyMDk5Mzc5MQ@@._V1_.jpg,"Crime, Drama"
1059,When Harry Met Sally...,1013,921,92,https://www.imdb.com/title/tt0098635/,https://m.media-amazon.com/images/M/MV5BMjE0ODEwNjM2NF5BMl5BanBnXkFtZTcwMjU2Mzg3NA@@._V1_.jpg,"Comedy, Drama, Romance"
1060,National Lampoon's Christmas Vacation,1167,1120,47,https://www.imdb.com/title/tt0097958/,https://m.media-amazon.com/images/M/MV5BOWM5NDNiMmItOWJiZC00NDVmLWE5MGEtMGE5NzcxMTY3ODYwXkEyXkFqcGdeQXVyMTcwOTQzOTYy._V1_.jpg,Comedy
1062,The Little Mermaid,1549,265,1284,https://www.imdb.com/title/tt0097757/,https://m.media-amazon.com/images/M/MV5BOWUyNDA0ZmItMzg2My00YjJhLTk1N2QtYTAxYTc0NzMzNDI0XkEyXkFqcGdeQXVyMTI5NzUyMTIz._V1_.jpg,"Animation, Adventure, Family"
1064,The Naked Gun: From the Files of Police Squad!,909,1918,-1009,https://www.imdb.com/title/tt0095705/,https://m.media-amazon.com/images/M/MV5BODk1ZWM4ZjItMjFhZi00MDMxLTgxNmYtODFhNWZlZTkwM2UwXkEyXkFqcGdeQXVyMTQxNzMzNDI@._V1_.jpg,"Comedy, Crime"
1068,RoboCop,999,1934,-935,https://www.imdb.com/title/tt0093870/,https://m.media-amazon.com/images/M/MV5BZWVlYzU2ZjQtZmNkMi00OTc3LTkwZmYtZDVjNmY4OWFmZGJlXkEyXkFqcGdeQXVyMTQxNzMzNDI@._V1_.jpg,"Action, Crime, Sci-Fi"
1069,"Planes, Trains & Automobiles",993,1554,-561,https://www.imdb.com/title/tt0093748/,https://m.media-amazon.com/images/M/MV5BNWRjZmFlMDAtZjljYy00YjUwLTgyMDQtMTI5ZjhiZTNkNDNhXkEyXkFqcGdeQXVyMTUzMDUzNTI3._V1_.jpg,"Comedy, Drama"
1070,Lethal Weapon,901,1367,-466,https://www.imdb.com/title/tt0093409/,https://m.media-amazon.com/images/M/MV5BZTllNWNlZjctMWQwMS00ZDc3LTg5ZjMtNzhmNzhjMmVhYTFlXkEyXkFqcGdeQXVyNTc1NTQxODI@._V1_.jpg,"Action, Crime, Thriller"
1071,The Fly,949,1738,-789,https://www.imdb.com/title/tt0091064/,https://m.media-amazon.com/images/M/MV5BODcxMGMwOGEtMDUxMi00MzE5LTg4YTYtYjk1YjA4MzQxNTNlXkEyXkFqcGdeQXVyNzkwMjQ5NzM@._V1_.jpg,"Drama, Horror, Sci-Fi"
1073,Indiana Jones and the Temple of Doom,1050,1145,-95,https://www.imdb.com/title/tt0087469/,https://m.media-amazon.com/images/M/MV5BYzgzMTIzNzctNmNiZC00ZDYyLWJjNzktMmQ2MDM2ZDkwZGVhXkEyXkFqcGdeQXVyMjM4MzQ4OTQ@._V1_.jpg,"Action, Adventure"
1078,The Road Warrior,873,1805,-932,https://www.imdb.com/title/tt0082694/,https://m.media-amazon.com/images/M/MV5BN2VlNjNhZWQtMTY2OC00Y2E1LWJkNGUtMDU4M2ViNzliMGYwXkEyXkFqcGdeQXVyNTAyODkwOQ@@._V1_.jpg,"Action, Adventure, Sci-Fi"
1082,Escape from Alcatraz,974,1220,-246,https://www.imdb.com/title/tt0079116/,https://m.media-amazon.com/images/M/MV5BMzI0NTIzM2QtZDBkZC00N2JjLWI5OGMtMzg2YjFjODI2ZTkwXkEyXkFqcGdeQXVyMjUzOTY1NTc@._V1_.jpg,"Action, Biography, Crime"
1086,Close Encounters of the Third Kind,894,1278,-384,https://www.imdb.com/title/tt0075860/,https://m.media-amazon.com/images/M/MV5BMjM1NjE5NjQxN15BMl5BanBnXkFtZTgwMjYzMzQxMDE@._V1_.jpg,"Drama, Sci-Fi"
1088,Robin Hood,1086,843,243,https://www.imdb.com/title/tt0070608/,https://m.media-amazon.com/images/M/MV5BYjUwMzhkM2ItMTU2OC00OTQ5LWJlMDUtMzRmYjc0NDUyNGVhL2ltYWdlL2ltYWdlXkEyXkFqcGdeQXVyMTQxNzMzNDI@._V1_.jpg,"Animation, Adventure, Comedy"
1097,The Jungle Book,924,1069,-145,https://www.imdb.com/title/tt0061852/,https://m.media-amazon.com/images/M/MV5BYmY1MTA3NmUtYzJmZC00YTFjLTk2NzktYTJhMWQ0ZTlkNzJjXkEyXkFqcGdeQXVyNjc5NjEzNA@@._V1_.jpg,"Animation, Adventure, Comedy"
1104,Breakfast at Tiffany's,1133,475,658,https://www.imdb.com/title/tt0054698/,https://m.media-amazon.com/images/M/MV5BNGEwMTRmZTQtMDY4Ni00MTliLTk5ZmMtOWMxYWMyMTllMDg0L2ltYWdlL2ltYWdlXkEyXkFqcGdeQXVyNjc1NTYyMjg@._V1_.jpg,"Comedy, Drama, Romance"
1115,Snow White and the Seven Dwarfs,991,893,98,https://www.imdb.com/title/tt0029583/,https://m.media-amazon.com/images/M/MV5BMTQwMzE2Mzc4M15BMl5BanBnXkFtZTcwMTE4NTc1Nw@@._V1_.jpg,"Animation, Adventure, Family"
1121,The Lighthouse,1272,1930,-658,https://www.imdb.com/title/tt7984734/,https://m.media-amazon.com/images/M/MV5BZmE0MGJhNmYtOWNjYi00Njc5LWE2YjEtMWMxZTVmODUwMmMxXkEyXkFqcGdeQXVyMTkxNjUyNQ@@._V1_.jpg,"Drama, Fantasy, Horror"
1122,BlacKkKlansman,1341,908,433,https://www.imdb.com/title/tt7349662/,https://m.media-amazon.com/images/M/MV5BMjUyOTE1NjI0OF5BMl5BanBnXkFtZTgwMTM4ODQ5NTM@._V1_.jpg,"Biography, Comedy, Crime"
1125,Tenet,1357,1737,-380,https://www.imdb.com/title/tt6723592/,https://m.media-amazon.com/images/M/MV5BMzU3YWYwNTQtZTdiMC00NjY5LTlmMTMtZDFlYTEyODBjMTk5XkEyXkFqcGdeQXVyMTkxNjUyNQ@@._V1_.jpg,"Action, Sci-Fi, Thriller"
1126,A Quiet Place,1237,1078,159,https://www.imdb.com/title/tt6644200/,https://m.media-amazon.com/images/M/MV5BMjI0MDMzNTQ0M15BMl5BanBnXkFtZTgwMTM5NzM3NDM@._V1_.jpg,"Drama, Horror, Sci-Fi"
1127,Upgrade,1089,1552,-463,https://www.imdb.com/title/tt6499752/,https://m.media-amazon.com/images/M/MV5BMjI0NzcyMjM5Ml5BMl5BanBnXkFtZTgwMzk2NzAyNTM@._V1_.jpg,"Action, Sci-Fi, Thriller"
1128,Spider-Man: Far from Home,1318,903,415,https://www.imdb.com/title/tt6320628/,https://m.media-amazon.com/images/M/MV5BODA5MTY0OWUtNjdlOC00NDI5LWE3NjYtNDM4MDI2MzE4OWUxXkEyXkFqcGdeQXVyOTAzODkzMjI@._V1_.jpg,"Action, Adventure, Comedy"
1129,Phantom Thread,1147,1795,-648,https://www.imdb.com/title/tt5776858/,https://m.media-amazon.com/images/M/MV5BMWJkNzBkM2UtYWFlMC00NmEwLTgxOGUtMjVmMzYyZjgyMmEzXkEyXkFqcGdeQXVyMjM4NTM5NDY@._V1_.jpg,"Drama, Romance"
1131,"I, Tonya",1276,1212,64,https://www.imdb.com/title/tt5580036/,https://m.media-amazon.com/images/M/MV5BMjI5MDY1NjYzMl5BMl5BanBnXkFtZTgwNjIzNDAxNDM@._V1_.jpg,"Biography, Comedy, Drama"
1132,The Big Sick,1049,1355,-306,https://www.imdb.com/title/tt5462602/,https://m.media-amazon.com/images/M/MV5BZjc1YzExMzYtNzVkZC00ODc3LTkxNzktMDI5YWZmMDQ2NTQ2XkEyXkFqcGdeQXVyMTA4NjE0NjEy._V1_.jpg,"Comedy, Drama, Romance"
1135,The Favourite,1030,1419,-389,https://www.imdb.com/title/tt5083738/,https://m.media-amazon.com/images/M/MV5BMTg1NzQwMDQxNV5BMl5BanBnXkFtZTgwNDg2NDYyNjM@._V1_.jpg,"Biography, Comedy, Drama"
1136,Nocturnal Animals,1159,1479,-320,https://www.imdb.com/title/tt4550098/,https://m.media-amazon.com/images/M/MV5BMTYwMzMwMzgxNl5BMl5BanBnXkFtZTgwMTA0MTUzMDI@._V1_.jpg,"Drama, Thriller"
1138,John Wick: Chapter 2,1323,1608,-285,https://www.imdb.com/title/tt4425200/,https://m.media-amazon.com/images/M/MV5BMjE2NDkxNTY2M15BMl5BanBnXkFtZTgwMDc2NzE0MTI@._V1_.jpg,"Action, Crime, Thriller"
1143,Still Alice,1274,963,311,https://www.imdb.com/title/tt3316960/,https://m.media-amazon.com/images/M/MV5BMjIzNzAxNjY1Nl5BMl5BanBnXkFtZTgwMDg4ODQxMzE@._V1_.jpg,Drama
1147,Predestination,1168,1387,-219,https://www.imdb.com/title/tt2397535/,https://m.media-amazon.com/images/M/MV5BY2NhNTc1OWYtODY0Zi00YjU1LTljNGItNTAzZjY5MjJlNDdmXkEyXkFqcGdeQXVyMTU0NTE4MTkz._V1_.jpg,"Action, Drama, Sci-Fi"
1148,How to Train Your Dragon: The Hidden World,1469,673,796,https://www.imdb.com/title/tt2386490/,https://m.media-amazon.com/images/M/MV5BMjIwMDIwNjAyOF5BMl5BanBnXkFtZTgwNDE1MDc2NTM@._V1_.jpg,"Animation, Action, Adventure"
1149,Brooklyn,1296,1060,236,https://www.imdb.com/title/tt2381111/,https://m.media-amazon.com/images/M/MV5BMzE4MDk5NzEyOV5BMl5BanBnXkFtZTgwNDM4NDA3NjE@._V1_.jpg,"Drama, Romance"
1153,Saving Mr. Banks,1382,927,455,https://www.imdb.com/title/tt2140373/,https://m.media-amazon.com/images/M/MV5BMTc0MTQ3NzE4Nl5BMl5BanBnXkFtZTcwMzA4NDM5OQ@@._V1_.jpg,"Biography, Comedy, Drama"
1155,Inside Llewyn Davis,1164,1837,-673,https://www.imdb.com/title/tt2042568/,https://m.media-amazon.com/images/M/MV5BMjAxNjcyNDQxM15BMl5BanBnXkFtZTgwNzU2NDA0MDE@._V1_.jpg,"Drama, Music"
1156,The Hunger Games: Catching Fire,1367,360,1007,https://www.imdb.com/title/tt1951264/,https://m.media-amazon.com/images/M/MV5BMTAyMjQ3OTAxMzNeQTJeQWpwZ15BbWU4MDU0NzA1MzAx._V1_.jpg,"Action, Adventure, Sci-Fi"
1158,127 Hours,944,1208,-264,https://www.imdb.com/title/tt1542344/,https://m.media-amazon.com/images/M/MV5BMTc2NjMzOTE3Ml5BMl5BanBnXkFtZTcwMDE0OTc5Mw@@._V1_.jpg,"Biography, Drama"
1159,Sherlock Holmes: A Game of Shadows,1213,1064,149,https://www.imdb.com/title/tt1515091/,https://m.media-amazon.com/images/M/MV5BMTQwMzQ5Njk1MF5BMl5BanBnXkFtZTcwNjIxNzIxNw@@._V1_.jpg,"Action, Adventure, Mystery"
1161,Tucker and Dale vs Evil,1087,1087,0,https://www.imdb.com/title/tt1465522/,https://m.media-amazon.com/images/M/MV5BODQ5NDQ0MjkwMF5BMl5BanBnXkFtZTcwNDg1OTU4NQ@@._V1_.jpg,"Comedy, Horror"
1162,The Conjuring,1227,1273,-46,https://www.imdb.com/title/tt1457767/,https://m.media-amazon.com/images/M/MV5BMTM3NjA1NDMyMV5BMl5BanBnXkFtZTcwMDQzNDMzOQ@@._V1_.jpg,"Horror, Mystery, Thriller"
1168,We Need to Talk About Kevin,1262,847,415,https://www.imdb.com/title/tt1242460/,https://m.media-amazon.com/images/M/MV5BMjE0NDE0MjYxNF5BMl5BanBnXkFtZTcwNjM2NTY5Ng@@._V1_.jpg,"Drama, Mystery, Thriller"
1170,Doctor Strange,1209,961,248,https://www.imdb.com/title/tt1211837/,https://m.media-amazon.com/images/M/MV5BNjgwNzAzNjk1Nl5BMl5BanBnXkFtZTgwMzQ2NjI1OTE@._V1_.jpg,"Action, Adventure, Fantasy"
1172,Lone Survivor,1189,898,291,https://www.imdb.com/title/tt1091191/,https://m.media-amazon.com/images/M/MV5BMjA0NTgwOTk5Ml5BMl5BanBnXkFtZTcwMjE3NDc5OQ@@._V1_.jpg,"Action, Biography, Drama"
1175,Milk,1150,830,320,https://www.imdb.com/title/tt1013753/,https://m.media-amazon.com/images/M/MV5BYTQ1MTk5YmYtZWUxNi00MDQxLTg0NzAtMmM4ZDkzY2E3YjQwXkEyXkFqcGdeQXVyNjk1Njg5NTA@._V1_.jpg,"Biography, Drama, History"
1176,Hugo,1202,1104,98,https://www.imdb.com/title/tt0970179/,https://m.media-amazon.com/images/M/MV5BMjAzNzk5MzgyNF5BMl5BanBnXkFtZTcwOTE4NDU5Ng@@._V1_.jpg,"Adventure, Drama, Family"
1177,Source Code,1192,1452,-260,https://www.imdb.com/title/tt0945513/,https://m.media-amazon.com/images/M/MV5BMTY0MTc3MzMzNV5BMl5BanBnXkFtZTcwNDE4MjE0NA@@._V1_.jpg,"Action, Drama, Mystery"
1178,Doubt,1105,1371,-266,https://www.imdb.com/title/tt0918927/,https://m.media-amazon.com/images/M/MV5BYWFjZmE2NGYtNGIzYi00Nzc2LTlhZWMtMTNkOTBkOTQ0MTJmXkEyXkFqcGdeQXVyMTkzODUwNzk@._V1_.jpg,"Drama, Mystery"
1179,The Hurt Locker,1045,1361,-316,https://www.imdb.com/title/tt0887912/,https://m.media-amazon.com/images/M/MV5BYWYxZjU2MmQtMmMzYi00ZWUwLTg2ZWQtMDExZTVlYjM3ZWM1XkEyXkFqcGdeQXVyNzkwMjQ5NzM@._V1_.jpg,"Drama, Thriller, War"
1180,The Town,1072,1585,-513,https://www.imdb.com/title/tt0840361/,https://m.media-amazon.com/images/M/MV5BMTcyNzcxODg3Nl5BMl5BanBnXkFtZTcwMTUyNjQ3Mw@@._V1_.jpg,"Crime, Drama, Thriller"
1185,Grindhouse,1053,1020,33,https://www.imdb.com/title/tt0462322/,https://m.media-amazon.com/images/M/MV5BMjA0MzExNzc3MV5BMl5BanBnXkFtZTcwODAxMzM0MQ@@._V1_.jpg,"Action, Horror, Thriller"
1189,Scott Pilgrim vs. the World,1081,1617,-536,https://www.imdb.com/title/tt0446029/,https://m.media-amazon.com/images/M/MV5BNWI5ODc4MTAtN2U2NC00ZDk3LWE3NjAtNjIyODE2YTlhYjYwXkEyXkFqcGdeQXVyOTA3ODI3NDA@._V1_.jpg,"Action, Comedy, Fantasy"
1190,The Assassination of Jesse James by the Coward Robert Ford,1178,1670,-492,https://www.imdb.com/title/tt0443680/,https://m.media-amazon.com/images/M/MV5BMTY2NDI2MTc2NV5BMl5BanBnXkFtZTcwNjA2NTQzMw@@._V1_.jpg,"Biography, Crime, Drama"
1192,August Rush,1411,750,661,https://www.imdb.com/title/tt0426931/,https://m.media-amazon.com/images/M/MV5BNDIwNjE3NjU2NV5BMl5BanBnXkFtZTcwNTQ2NjQzMw@@._V1_.jpg,"Drama, Music"
1193,Stranger Than Fiction,1022,1142,-120,https://www.imdb.com/title/tt0420223/,https://m.media-amazon.com/images/M/MV5BMmE2ZjYwNGYtYWMyMS00M2I0LWI4NDEtMzc1MTllMjk0ZmFmXkEyXkFqcGdeQXVyNTIzOTk5ODM@._V1_.jpg,"Comedy, Drama, Fantasy"
1196,Munich,1006,1576,-570,https://www.imdb.com/title/tt0408306/,https://m.media-amazon.com/images/M/MV5BMTcwNzYzMzMwMF5BMl5BanBnXkFtZTcwMzMzODczMQ@@._V1_.jpg,"Action, Drama, History"
1197,Little Children,1138,1492,-354,https://www.imdb.com/title/tt0404203/,https://m.media-amazon.com/images/M/MV5BMTYwNzEwNTI3MV5BMl5BanBnXkFtZTcwODUyODczMQ@@._V1_.jpg,"Drama, Romance"
1198,Perfume: The Story of a Murderer,1157,1153,4,https://www.imdb.com/title/tt0396171/,https://m.media-amazon.com/images/M/MV5BMTg2Mzk2NjkzNl5BMl5BanBnXkFtZTYwMzIzOTc2._V1_.jpg,"Crime, Drama, Fantasy"
1199,House of Flying Daggers,1230,774,456,https://www.imdb.com/title/tt0385004/,https://m.media-amazon.com/images/M/MV5BZDExZGI3MjMtN2VkNi00MzY2LWEwY2ItZTdiYzgwOGVlOWYyXkEyXkFqcGdeQXVyMTcwOTQzOTYy._V1_.jpg,"Action, Adventure, Drama"
1200,Green Street Hooligans,1248,1115,133,https://www.imdb.com/title/tt0385002/,https://m.media-amazon.com/images/M/MV5BMjExNTg3NzYwMV5BMl5BanBnXkFtZTcwMzcxMTEzMQ@@._V1_.jpg,"Crime, Drama, Sport"
1201,Sideways,1112,1941,-829,https://www.imdb.com/title/tt0375063/,https://m.media-amazon.com/images/M/MV5BMTU0Mjg3MzkxOV5BMl5BanBnXkFtZTYwNDU1OTY3._V1_.jpg,"Comedy, Drama, Romance"
1202,Harry Potter and the Order of the Phoenix,1395,464,931,https://www.imdb.com/title/tt0373889/,https://m.media-amazon.com/images/M/MV5BOTA3MmRmZDgtOWU1Ny00ZDc5LWFkN2YtNzNlY2UxZmY0N2IyXkEyXkFqcGdeQXVyNTIzOTk5ODM@._V1_.jpg,"Action, Adventure, Family"
1203,Kiss Kiss Bang Bang,1044,1324,-280,https://www.imdb.com/title/tt0373469/,https://m.media-amazon.com/images/M/MV5BMTY5NDExMDA3M15BMl5BanBnXkFtZTYwNTc2MzA3._V1_.jpg,"Comedy, Crime, Mystery"
1204,Collateral,996,1835,-839,https://www.imdb.com/title/tt0369339/,https://m.media-amazon.com/images/M/MV5BMjE3NjM5OTMxMV5BMl5BanBnXkFtZTcwOTIzMTQyMw@@._V1_.jpg,"Action, Crime, Drama"
1209,The Aviator,1118,1494,-376,https://www.imdb.com/title/tt0338751/,https://m.media-amazon.com/images/M/MV5BZTYzMjA2M2EtYmY1OC00ZWMxLThlY2YtZGI3MTQzOWM4YjE3XkEyXkFqcGdeQXVyMTQxNzMzNDI@._V1_.jpg,"Biography, Drama"
1213,The Hours,1314,864,450,https://www.imdb.com/title/tt0274558/,https://m.media-amazon.com/images/M/MV5BYTk0ODJkMzItZmRkNy00NThhLTg1ZTQtNDIxNjYwNDJmNjRlXkEyXkFqcGdeQXVyNjk1Njg5NTA@._V1_.jpg,"Drama, Romance"
1214,Ice Age,1096,770,326,https://www.imdb.com/title/tt0268380/,https://m.media-amazon.com/images/M/MV5BM2JmZGJkNzAtOWI0MC00ZmE5LWIwMjYtODU0OGUxNDg4ZDkwXkEyXkFqcGdeQXVyMTA5ODEyNTc5._V1_.jpg,"Animation, Adventure, Comedy"
1217,The Man Who Wasn't There,1007,1363,-356,https://www.imdb.com/title/tt0243133/,https://m.media-amazon.com/images/M/MV5BYjEwMGZkYTgtMTA5Ny00OWFhLTgzMWItYjhhMWUxYTIxNDgwXkEyXkFqcGdeQXVyNTc1NTQxODI@._V1_.jpg,"Crime, Drama"
1219,Gangs of New York,985,1616,-631,https://www.imdb.com/title/tt0217505/,https://m.media-amazon.com/images/M/MV5BNDg3MmI1ZDYtMDZjYi00ZWRlLTk4NzEtZjY4Y2U0NjE5YmRiXkEyXkFqcGdeQXVyNzAxMjE1NDg@._V1_.jpg,"Crime, Drama"
1226,High Fidelity,1193,1527,-334,https://www.imdb.com/title/tt0146882/,https://m.media-amazon.com/images/M/MV5BMTgxMTI1ODYyOV5BMl5BanBnXkFtZTYwNjQyOTI3._V1_.jpg,"Comedy, Drama, Music"
1228,Star Wars: Episode III - Revenge of the Sith,1103,1398,-295,https://www.imdb.com/title/tt0121766/,https://m.media-amazon.com/images/M/MV5BNTc4MTc3NTQ5OF5BMl5BanBnXkFtZTcwOTg0NjI4NA@@._V1_.jpg,"Action, Adventure, Fantasy"
1229,Pleasantville,1261,991,270,https://www.imdb.com/title/tt0120789/,https://m.media-amazon.com/images/M/MV5BYTRlYzk4NDktODE3Ni00YjFkLWFjYmUtNjg1MzdmYmFmOTJkXkEyXkFqcGdeQXVyMTAwMzUyOTc@._V1_.jpg,"Comedy, Drama, Fantasy"
1233,Jackie Brown,1135,1271,-136,https://www.imdb.com/title/tt0119396/,https://m.media-amazon.com/images/M/MV5BNmY5ODRmYTItNWU0Ni00MWE3LTgyYzUtYjZlN2Q5YTcyM2NmXkEyXkFqcGdeQXVyNjU0OTQ0OTY@._V1_.jpg,"Crime, Drama, Thriller"
1234,The Devil's Advocate,1175,1077,98,https://www.imdb.com/title/tt0118971/,https://m.media-amazon.com/images/M/MV5BM2M2MDJhMDgtMmJkYy00MTgzLTkyZTktODM5NzE1MWUyNDA4XkEyXkFqcGdeQXVyNTA4NzY1MzY@._V1_.jpg,"Drama, Fantasy, Mystery"
1237,A Time to Kill,1322,816,506,https://www.imdb.com/title/tt0117913/,https://m.media-amazon.com/images/M/MV5BM2U4OThhNTQtN2JmZi00OWY0LThmZjYtMzNhZmExMWM0OTNjXkEyXkFqcGdeQXVyMTUzMDUzNTI3._V1_.jpg,"Crime, Drama, Thriller"
1238,Leaving Las Vegas,1111,1632,-521,https://www.imdb.com/title/tt0113627/,https://m.media-amazon.com/images/M/MV5BNDg3MDM5NTI0MF5BMl5BanBnXkFtZTcwNDY0NDk0NA@@._V1_.jpg,"Drama, Romance"
1242,Interview with the Vampire: The Vampire Chronicles,1142,773,369,https://www.imdb.com/title/tt0110148/,https://m.media-amazon.com/images/M/MV5BYThmYjJhMGItNjlmOC00ZDRiLWEzNjUtZjU4MjA3MzY0MzFmXkEyXkFqcGdeQXVyNTI4MjkwNjA@._V1_.jpg,"Drama, Fantasy, Horror"
1247,Army of Darkness,1210,1471,-261,https://www.imdb.com/title/tt0106308/,https://m.media-amazon.com/images/M/MV5BODcyYzM4YTAtNGM5MS00NjU4LTk2Y2ItZjI5NjkzZTk0MmQ1XkEyXkFqcGdeQXVyNjU0OTQ0OTY@._V1_.jpg,"Comedy, Horror"
1253,Thelma & Louise,1349,675,674,https://www.imdb.com/title/tt0103074/,https://m.media-amazon.com/images/M/MV5BMjIxNDgzMDE2MF5BMl5BanBnXkFtZTcwNzY5NTk1NA@@._V1_.jpg,"Adventure, Crime, Drama"
1255,Total Recall,1023,1776,-753,https://www.imdb.com/title/tt0100802/,https://m.media-amazon.com/images/M/MV5BYzU1YmJjMGEtMjY4Yy00MTFlLWE3NTUtNzI3YjkwZTMxZjZmXkEyXkFqcGdeQXVyNDc2NjEyMw@@._V1_.jpg,"Action, Adventure, Sci-Fi"
1258,Field of Dreams,1165,1542,-377,https://www.imdb.com/title/tt0097351/,https://m.media-amazon.com/images/M/MV5BNzk5OWY0YjAtYWU3ZS00Y2Q4LWFlNjItMzgwMTQ2MjIyMDFmL2ltYWdlL2ltYWdlXkEyXkFqcGdeQXVyMTQxNzMzNDI@._V1_.jpg,"Drama, Family, Fantasy"
1259,Batman,1102,1345,-243,https://www.imdb.com/title/tt0096895/,https://m.media-amazon.com/images/M/MV5BZWQ0OTQ3ODctMmE0MS00ODc2LTg0ZTEtZWIwNTUxOGExZTQ4XkEyXkFqcGdeQXVyNzAwMjU2MTY@._V1_.jpg,"Action, Adventure"
1260,The Abyss,982,1281,-299,https://www.imdb.com/title/tt0096754/,https://m.media-amazon.com/images/M/MV5BYmU4NmUxZjEtYjY0OC00ZDAwLTg0MGQtMDRkNDk5NWQ0OTQ5XkEyXkFqcGdeQXVyMjUzOTY1NTc@._V1_.jpg,"Adventure, Drama, Mystery"
1263,A Fish Called Wanda,1108,1298,-190,https://www.imdb.com/title/tt0095159/,https://m.media-amazon.com/images/M/MV5BNTQ0ODhiNjEtMDFiYi00NmZhLWJkMzQtNTBkOGQwOTliZDAxXkEyXkFqcGdeQXVyMTQxNzMzNDI@._V1_.jpg,"Comedy, Crime"
1264,Beetlejuice,1243,905,338,https://www.imdb.com/title/tt0094721/,https://m.media-amazon.com/images/M/MV5BZDdmNjBlYTctNWU0MC00ODQxLWEzNDQtZGY1NmRhYjNmNDczXkEyXkFqcGdeQXVyMTQxNzMzNDI@._V1_.jpg,"Comedy, Fantasy"
1268,A Nightmare on Elm Street,1185,1435,-250,https://www.imdb.com/title/tt0087800/,https://m.media-amazon.com/images/M/MV5BNzFjZmM1ODgtMDBkMS00NWFlLTg2YmUtZjc3ZTgxMjE1OTI2L2ltYWdlXkEyXkFqcGdeQXVyNTAyODkwOQ@@._V1_.jpg,Horror
1270,Trading Places,1197,1507,-310,https://www.imdb.com/title/tt0086465/,https://m.media-amazon.com/images/M/MV5BZGVjNTBiYWUtY2MwOC00NTg1LWJiNWMtNzM5MTBkYzE5NjQxXkEyXkFqcGdeQXVyMTUzMDUzNTI3._V1_.jpg,Comedy
1271,The Meaning of Life,1136,1014,122,https://www.imdb.com/title/tt0085959/,https://m.media-amazon.com/images/M/MV5BZWJkNGY5MDAtYmVkMy00NzdiLTk5MzctMzA0MjMxMDY2NGYwXkEyXkFqcGdeQXVyMTQxNzMzNDI@._V1_.jpg,"Comedy, Musical"
1272,The Evil Dead,1140,1729,-589,https://www.imdb.com/title/tt0083907/,https://m.media-amazon.com/images/M/MV5BNjRmY2NmN2UtMmRlMS00Mjg2LTgwNjUtZjYyZjc0NDJjODFkXkEyXkFqcGdeQXVyNjc5NjEzNA@@._V1_.jpg,Horror
1276,National Lampoon's Animal House,1073,1742,-669,https://www.imdb.com/title/tt0077975/,https://m.media-amazon.com/images/M/MV5BOGI2NDI3OGQtNTE4Mi00YmYwLThmMTItMzU5MzQ3ZGUyMWJjXkEyXkFqcGdeQXVyNjc5NjEzNA@@._V1_.jpg,Comedy
1277,The Omen,1052,1337,-285,https://www.imdb.com/title/tt0075005/,https://m.media-amazon.com/images/M/MV5BZmNjZDcwNTMtMjQxMy00ZTY5LTg4M2YtYjA5NDliNjNhYzQ3XkEyXkFqcGdeQXVyNjc1NTYyMjg@._V1_.jpg,"Horror, Mystery"
1280,The Texas Chain Saw Massacre,1183,1846,-663,https://www.imdb.com/title/tt0072271/,https://m.media-amazon.com/images/M/MV5BZDI3OWE0ZWMtNGJjOS00N2E4LWFiOTAtZjQ4OTNiNzIwN2NkXkEyXkFqcGdeQXVyMTQxNzMzNDI@._V1_.jpg,Horror
1296,Onward,1476,994,482,https://www.imdb.com/title/tt7146812/,https://m.media-amazon.com/images/M/MV5BMTZlYzk3NzQtMmViYS00YWZmLTk5ZTEtNWE0NGVjM2MzYWU1XkEyXkFqcGdeQXVyNDg4NjY5OTQ@._V1_.jpg,"Animation, Adventure, Comedy"
1300,John Wick: Chapter 3 - Parabellum,1403,1501,-98,https://www.imdb.com/title/tt6146586/,https://m.media-amazon.com/images/M/MV5BMDg2YzI0ODctYjliMy00NTU0LTkxODYtYTNkNjQwMzVmOTcxXkEyXkFqcGdeQXVyNjg2NjQwMDQ@._V1_.jpg,"Action, Crime, Thriller"
1301,Uncut Gems,1215,1993,-778,https://www.imdb.com/title/tt5727208/,https://m.media-amazon.com/images/M/MV5BZDhkMjUyYjItYWVkYi00YTM5LWE4MGEtY2FlMjA3OThlYmZhXkEyXkFqcGdeQXVyODk4OTc3MTY@._V1_.jpg,"Crime, Drama, Thriller"
1304,Moonlight,1462,1093,369,https://www.imdb.com/title/tt4975722/,https://m.media-amazon.com/images/M/MV5BNzQxNTIyODAxMV5BMl5BanBnXkFtZTgwNzQyMDA3OTE@._V1_.jpg,Drama
1305,Lady Bird,1345,1589,-244,https://www.imdb.com/title/tt4925292/,https://m.media-amazon.com/images/M/MV5BODhkZGE0NDQtZDc0Zi00YmQ4LWJiNmUtYTY1OGM1ODRmNGVkXkEyXkFqcGdeQXVyMTMxODk2OTU@._V1_.jpg,"Comedy, Drama"
1308,Darkest Hour,1377,1372,5,https://www.imdb.com/title/tt4555426/,https://m.media-amazon.com/images/M/MV5BMjIyNDkyMTgzMV5BMl5BanBnXkFtZTgwNTQwNjg2MzI@._V1_.jpg,"Drama, War"
1309,Molly's Game,1283,1137,146,https://www.imdb.com/title/tt4209788/,https://m.media-amazon.com/images/M/MV5BNTkzMzRlYjEtMTQ5Yi00OWY3LWI0NzYtNGQ4ZDkzZTU0M2IwXkEyXkFqcGdeQXVyMTMxODk2OTU@._V1_.jpg,"Biography, Crime, Drama"
1311,The Nice Guys,1396,1792,-396,https://www.imdb.com/title/tt3799694/,https://m.media-amazon.com/images/M/MV5BODNlNmU4MGItMzQwZi00NGQyLWEyZWItYjFkNmI0NWI4NjBhXkEyXkFqcGdeQXVyODE5NzE3OTE@._V1_.jpg,"Action, Comedy, Crime"
1314,The Disaster Artist,1428,1702,-274,https://www.imdb.com/title/tt3521126/,https://m.media-amazon.com/images/M/MV5BOGNkMzliMGMtMDI5Ni00OTZkLTgyMTYtNzk5ZTY1NjVhYjVmXkEyXkFqcGdeQXVyNTAzMTY4MDA@._V1_.jpg,"Biography, Comedy, Drama"
1315,War for the Planet of the Apes,1331,1323,8,https://www.imdb.com/title/tt3450958/,https://m.media-amazon.com/images/M/MV5BMjFmODRkZGUtNTY1MC00Y2E5LWIyMGMtMjlhZThmOTYyZTdkXkEyXkFqcGdeQXVyMTUyOTc1NDYz._V1_.jpg,"Action, Adventure, Drama"
1316,Sully,1277,1139,138,https://www.imdb.com/title/tt3263904/,https://m.media-amazon.com/images/M/MV5BY2NmZDAwM2QtZmFiMS00OTJlLTgxMTItZDMyZmVhYjE1MDY3XkEyXkFqcGdeQXVyMTMxODk2OTU@._V1_.jpg,"Biography, Drama"
1317,The Jungle Book,924,1069,-145,https://www.imdb.com/title/tt3040964/,https://m.media-amazon.com/images/M/MV5BMTc3NTUzNTI4MV5BMl5BanBnXkFtZTgwNjU0NjU5NzE@._V1_.jpg,"Animation, Action, Adventure"
1318,John Wick,1502,1664,-162,https://www.imdb.com/title/tt2911666/,https://m.media-amazon.com/images/M/MV5BMTU2NjA1ODgzMF5BMl5BanBnXkFtZTgwMTM2MTI4MjE@._V1_.jpg,"Action, Crime, Thriller"
1319,I Origins,1588,889,699,https://www.imdb.com/title/tt2884206/,https://m.media-amazon.com/images/M/MV5BOTc4NWJjYTctZDhjOS00Y2MyLWEwYWYtNDVmYmJhN2VlYzU5XkEyXkFqcGdeQXVyMjQwMjk0NjI@._V1_.jpg,"Drama, Mystery, Romance"
1321,Me Before You,1851,1039,812,https://www.imdb.com/title/tt2674426/,https://m.media-amazon.com/images/M/MV5BMTQ2NjE4NDE2NV5BMl5BanBnXkFtZTgwOTcwNDE5NzE@._V1_.jpg,"Drama, Romance"
1325,Mission: Impossible - Rogue Nation,1371,1543,-172,https://www.imdb.com/title/tt2381249/,https://m.media-amazon.com/images/M/MV5BOTFmNDA3ZjMtN2Y0MC00NDYyLWFlY2UtNTQ4OTQxMmY1NmVjXkEyXkFqcGdeQXVyNTg4NDQ4NDY@._V1_.jpg,"Action, Adventure, Thriller"
1326,The Hobbit: The Battle of the Five Armies,1437,884,553,https://www.imdb.com/title/tt2310332/,https://m.media-amazon.com/images/M/MV5BMTYzNDE3OTQ3MF5BMl5BanBnXkFtZTgwODczMTg4MjE@._V1_.jpg,"Adventure, Fantasy"
1327,Frozen,1439,614,825,https://www.imdb.com/title/tt2294629/,https://m.media-amazon.com/images/M/MV5BMTQ1MjQwMTE5OF5BMl5BanBnXkFtZTgwNjk3MTcyMDE@._V1_.jpg,"Animation, Adventure, Comedy"
1328,Spider-Man: Homecoming,1366,1182,184,https://www.imdb.com/title/tt2250912/,https://m.media-amazon.com/images/M/MV5BODY2MTAzOTQ4M15BMl5BanBnXkFtZTgwNzg5MTE0MjI@._V1_.jpg,"Action, Adventure, Sci-Fi"
1331,Begin Again,1346,1399,-53,https://www.imdb.com/title/tt1980929/,https://m.media-amazon.com/images/M/MV5BNjAxMTI4MTgzMV5BMl5BanBnXkFtZTgwOTAwODEwMjE@._V1_.jpg,"Comedy, Drama, Music"
1333,Mud,1275,1782,-507,https://www.imdb.com/title/tt1935179/,https://m.media-amazon.com/images/M/MV5BMTU2MzcyODgyNV5BMl5BanBnXkFtZTcwNTc4MDYwOQ@@._V1_.jpg,"Adventure, Drama"
1335,The Judge,1353,1047,306,https://www.imdb.com/title/tt1872194/,https://m.media-amazon.com/images/M/MV5BMTcyNzIxOTIwMV5BMl5BanBnXkFtZTgwMzE0NjQwMjE@._V1_.jpg,"Crime, Drama, Mystery"
1337,Southpaw,1456,1129,327,https://www.imdb.com/title/tt1798684/,https://m.media-amazon.com/images/M/MV5BMjI1MTcwODk0MV5BMl5BanBnXkFtZTgwMTgwMDM5NTE@._V1_.jpg,"Action, Drama, Sport"
1339,Zero Dark Thirty,1290,1578,-288,https://www.imdb.com/title/tt1790885/,https://m.media-amazon.com/images/M/MV5BMTQ4OTUyNzcwN15BMl5BanBnXkFtZTcwMTQ1NDE3OA@@._V1_.jpg,"Drama, History, Thriller"
1341,The Way Way Back,1406,1382,24,https://www.imdb.com/title/tt1727388/,https://m.media-amazon.com/images/M/MV5BNTU5ODk5NDg0Nl5BMl5BanBnXkFtZTcwNzQwMjI1OQ@@._V1_.jpg,"Comedy, Drama"
1342,Ready Player One,1306,1381,-75,https://www.imdb.com/title/tt1677720/,https://m.media-amazon.com/images/M/MV5BY2JiYTNmZTctYTQ1OC00YjU4LWEwMjYtZjkwY2Y5MDI0OTU3XkEyXkFqcGdeQXVyNTI4MzE4MDU@._V1_.jpg,"Action, Adventure, Sci-Fi"
1345,"Crazy, Stupid, Love.",1438,1202,236,https://www.imdb.com/title/tt1570728/,https://m.media-amazon.com/images/M/MV5BMTg2MjkwMTM0NF5BMl5BanBnXkFtZTcwMzc4NDg2NQ@@._V1_.jpg,"Comedy, Drama, Romance"
1348,Cloud Atlas,1295,1155,140,https://www.imdb.com/title/tt1371111/,https://m.media-amazon.com/images/M/MV5BMTczMTgxMjc4NF5BMl5BanBnXkFtZTcwNjM5MTA2OA@@._V1_.jpg,"Drama, Mystery, Sci-Fi"
1351,Looper,1287,1564,-277,https://www.imdb.com/title/tt1276104/,https://m.media-amazon.com/images/M/MV5BMTg5NTA3NTg4NF5BMl5BanBnXkFtZTcwNTA0NDYzOA@@._V1_.jpg,"Action, Drama, Sci-Fi"
1352,Mission: Impossible - Ghost Protocol,1383,1630,-247,https://www.imdb.com/title/tt1229238/,https://m.media-amazon.com/images/M/MV5BMTY4MTUxMjQ5OV5BMl5BanBnXkFtZTcwNTUyMzg5Ng@@._V1_.jpg,"Action, Adventure, Thriller"
1354,Limitless,1370,1524,-154,https://www.imdb.com/title/tt1219289/,https://m.media-amazon.com/images/M/MV5BYmViZGM0MGItZTdiYi00ZDU4LWIxNDYtNTc1NWQ5Njc2N2YwXkEyXkFqcGdeQXVyNDk3NzU2MTQ@._V1_.jpg,"Sci-Fi, Thriller"
1355,Law Abiding Citizen,1416,1146,270,https://www.imdb.com/title/tt1197624/,https://m.media-amazon.com/images/M/MV5BNTQ1NmZlNDktZTg0NS00ZjNhLTk5M2QtNzExNjUzY2MwMjliXkEyXkFqcGdeQXVyODE5NzE3OTE@._V1_.jpg,"Action, Crime, Drama"
1356,Up in the Air,1166,1885,-719,https://www.imdb.com/title/tt1193138/,https://m.media-amazon.com/images/M/MV5BMTI3MzYxMTA4NF5BMl5BanBnXkFtZTcwMDE4ODg3Mg@@._V1_.jpg,"Comedy, Drama, Romance"
1359,Pirate Radio,1410,820,590,https://www.imdb.com/title/tt1131729/,https://m.media-amazon.com/images/M/MV5BMTMzMjYzMTMyM15BMl5BanBnXkFtZTcwOTk5NDA5Mg@@._V1_.jpg,"Comedy, Drama, Music"
1360,Blue Valentine,1332,1707,-375,https://www.imdb.com/title/tt1120985/,https://m.media-amazon.com/images/M/MV5BMTU4MTQ2MzA1Ml5BMl5BanBnXkFtZTcwODE3NTgwNA@@._V1_.jpg,"Drama, Romance"
1364,REC,1196,1832,-636,https://www.imdb.com/title/tt1038988/,https://m.media-amazon.com/images/M/MV5BZTI1ODM2ZWEtYmM5NS00ZDYzLWI1YzktYWYwZTdmOWMwZTBmXkEyXkFqcGdeQXVyMTU3NDU4MDg2._V1_.jpg,"Horror, Mystery, Thriller"
1367,The Bucket List,1338,1170,168,https://www.imdb.com/title/tt0825232/,https://m.media-amazon.com/images/M/MV5BMTY2NTUyMjIyNF5BMl5BanBnXkFtZTYwNzYwMDM4._V1_.jpg,"Adventure, Comedy, Drama"
1368,Death at a Funeral,1520,1130,390,https://www.imdb.com/title/tt0795368/,https://m.media-amazon.com/images/M/MV5BMjE4OTIyNTM1MF5BMl5BanBnXkFtZTcwMjUzNTg0MQ@@._V1_.jpg,Comedy
1372,Juno,1337,1185,152,https://www.imdb.com/title/tt0467406/,https://m.media-amazon.com/images/M/MV5BMTIwMDgwODc5Nl5BMl5BanBnXkFtZTYwMjQzMDM4._V1_.jpg,"Comedy, Drama"
1374,The Orphanage,1325,1109,216,https://www.imdb.com/title/tt0464141/,https://m.media-amazon.com/images/M/MV5BNTRjZjUzMDEtMjM5MC00NTMzLWJlYzItNzYzNjIwZjc0YjIzXkEyXkFqcGdeQXVyMjgyNjk3MzE@._V1_.jpg,"Drama, Horror, Mystery"
1375,Wonder Woman,1567,798,769,https://www.imdb.com/title/tt0451279/,https://m.media-amazon.com/images/M/MV5BMTYzODQzYjQtNTczNC00MzZhLTg1ZWYtZDUxYmQ3ZTY4NzA1XkEyXkFqcGdeQXVyODE5NzE3OTE@._V1_.jpg,"Action, Adventure, Fantasy"
1376,Babel,1268,1267,1,https://www.imdb.com/title/tt0449467/,https://m.media-amazon.com/images/M/MV5BYTJkZDljNGYtNjRiNC00ZmY2LTg1NmItYTI1MTllNDQzMWVmXkEyXkFqcGdeQXVyMTMxODk2OTU@._V1_.jpg,Drama
1384,A History of Violence,1263,1831,-568,https://www.imdb.com/title/tt0399146/,https://m.media-amazon.com/images/M/MV5BMTczMzIzMTQ1OV5BMl5BanBnXkFtZTYwMDQwNjk2._V1_.jpg,"Action, Crime, Drama"
1385,Memoirs of a Geisha,1895,869,1026,https://www.imdb.com/title/tt0397535/,https://m.media-amazon.com/images/M/MV5BMTYxMzM4NTEzOV5BMl5BanBnXkFtZTcwNDMwNjQzMw@@._V1_.jpg,"Drama, Romance"
1388,The Constant Gardener,1380,1085,295,https://www.imdb.com/title/tt0387131/,https://m.media-amazon.com/images/M/MV5BOWZkODhlZjQtMzdiYi00MDg2LTgxZDItN2IxMDZhMWE0MDdmXkEyXkFqcGdeQXVyMTQxNzMzNDI@._V1_.jpg,"Drama, Mystery, Romance"
1389,The Terminal,1448,1642,-194,https://www.imdb.com/title/tt0362227/,https://m.media-amazon.com/images/M/MV5BYzY3YzNlZjctZTNiNC00MjUzLTlhM2ItNjdkNzAwMDhmYmRmXkEyXkFqcGdeQXVyMjgyNjk3MzE@._V1_.jpg,"Comedy, Drama, Romance"
1390,Garden State,1266,1506,-240,https://www.imdb.com/title/tt0333766/,https://m.media-amazon.com/images/M/MV5BMjc5MDE0NjkxOF5BMl5BanBnXkFtZTcwNzA0NTkyMw@@._V1_.jpg,"Comedy, Drama, Romance"
1392,Wallace & Gromit: The Curse of the Were-Rabbit,1297,1565,-268,https://www.imdb.com/title/tt0312004/,https://m.media-amazon.com/images/M/MV5BZmExY2Y3NGQtMzg5ZC00MGY1LTk3ZjktNWYyYzYwMTA1MTUwXkEyXkFqcGdeQXVyNjk1Njg5NTA@._V1_.jpg,"Animation, Adventure, Comedy"
1393,Master and Commander: The Far Side of the World,1344,1708,-364,https://www.imdb.com/title/tt0311113/,https://m.media-amazon.com/images/M/MV5BZGRjM2IyM2EtZDAxYi00NTdjLTliMGYtMmRhZGUyNjRjNWYwXkEyXkFqcGdeQXVyODE5NzE3OTE@._V1_.jpg,"Action, Adventure, Drama"
1395,Harry Potter and the Chamber of Secrets,1633,559,1074,https://www.imdb.com/title/tt0295297/,https://m.media-amazon.com/images/M/MV5BMjE0YjUzNDUtMjc5OS00MTU3LTgxMmUtODhkOThkMzdjNWI4XkEyXkFqcGdeQXVyMTA3MzQ4MTc0._V1_.jpg,"Adventure, Family, Fantasy"
1396,Irreversible,1401,1620,-219,https://www.imdb.com/title/tt0290673/,https://m.media-amazon.com/images/M/MV5BNTdhM2FhOWItM2NiNC00YjYwLTkxZGEtYzNhYWM3YzU2NDQzXkEyXkFqcGdeQXVyMTYzMDM0NTU@._V1_.jpg,"Crime, Drama, Mystery"
1397,X2: X-Men United,1328,1375,-47,https://www.imdb.com/title/tt0290334/,https://m.media-amazon.com/images/M/MV5BNDk0NjYxMzIzOF5BMl5BanBnXkFtZTYwMTc1MjU3._V1_.jpg,"Action, Sci-Fi, Thriller"
1398,A Walk to Remember,1694,1341,353,https://www.imdb.com/title/tt0281358/,https://m.media-amazon.com/images/M/MV5BMzU3NTYxM2MtNjViMS00YmNlLWEwM2MtYWI2MzgzNTkxODFjXkEyXkFqcGdeQXVyMTQxNzMzNDI@._V1_.jpg,"Drama, Romance"
1400,K-PAX,1373,1439,-66,https://www.imdb.com/title/tt0272152/,https://m.media-amazon.com/images/M/MV5BZjE2Mjc4Y2EtN2QyNy00YTI5LWFlMjUtYjkwOTdhYTliMTliXkEyXkFqcGdeQXVyMjA0MzYwMDY@._V1_.jpg,"Drama, Mystery, Sci-Fi"
1405,Equilibrium,1302,1126,176,https://www.imdb.com/title/tt0238380/,https://m.media-amazon.com/images/M/MV5BMTkzMzA1OTI3N15BMl5BanBnXkFtZTYwMzUyMDg5._V1_.jpg,"Action, Drama, Sci-Fi"
1407,Erin Brockovich,1595,1187,408,https://www.imdb.com/title/tt0195685/,https://m.media-amazon.com/images/M/MV5BYTA1NWRkNTktNDMxNS00NjE4LWEzMDAtNzA3YzlhYzRhNDA4L2ltYWdlXkEyXkFqcGdeQXVyMTQxNzMzNDI@._V1_.jpg,"Biography, Drama"
1408,Pi,1402,1518,-116,https://www.imdb.com/title/tt0138704/,https://m.media-amazon.com/images/M/MV5BMTk3MThhNGEtY2E4NS00MWMwLTg4MzQtMTk4ZTcwYzRlNDNiXkEyXkFqcGdeQXVyMjUzOTY1NTc@._V1_.jpg,"Drama, Horror, Mystery"
1409,The Talented Mr. Ripley,1451,1179,272,https://www.imdb.com/title/tt0134119/,https://m.media-amazon.com/images/M/MV5BODA3NDhiZjYtYTk2NS00ZWYwLTljYTQtMjU0NzcyMGEzNTU2L2ltYWdlL2ltYWdlXkEyXkFqcGdeQXVyMTQxNzMzNDI@._V1_.jpg,"Crime, Drama, Thriller"
1411,Man on the Moon,1225,1687,-462,https://www.imdb.com/title/tt0125664/,https://m.media-amazon.com/images/M/MV5BNDI1Mjc3MzAtZDk0OS00OTZlLTlhZjktNzA3ODgwZGY2NWIwXkEyXkFqcGdeQXVyMTQxNzMzNDI@._V1_.jpg,"Biography, Comedy, Drama"
1413,The Emperor's New Groove,1730,1008,722,https://www.imdb.com/title/tt0120917/,https://m.media-amazon.com/images/M/MV5BMjFkMzk2OWUtNjFmZC00ZTJhLTlkNGYtYjc2YWNkNmJmNzczXkEyXkFqcGdeQXVyMTQxNzMzNDI@._V1_.jpg,"Animation, Adventure, Comedy"
1414,X-Men,1481,1031,450,https://www.imdb.com/title/tt0120903/,https://m.media-amazon.com/images/M/MV5BZmIyMDk5NGYtYjQ5NS00ZWQxLTg2YzQtZDk1ZmM4ZDBlN2E3XkEyXkFqcGdeQXVyMTQxNzMzNDI@._V1_.jpg,"Action, Adventure, Sci-Fi"
1416,Eyes Wide Shut,1218,1975,-757,https://www.imdb.com/title/tt0120663/,https://m.media-amazon.com/images/M/MV5BYzMzZjcyNzEtZjE2OC00Yjk3LWExOGItODdhNzhkZTdmM2M0XkEyXkFqcGdeQXVyMjUzOTY1NTc@._V1_.jpg,"Drama, Mystery, Thriller"
1419,Contact,1286,1607,-321,https://www.imdb.com/title/tt0118884/,https://m.media-amazon.com/images/M/MV5BYWNkYmFiZjUtYmI3Ni00NzIwLTkxZjktN2ZkMjdhMzlkMDc3XkEyXkFqcGdeQXVyNDk3NzU2MTQ@._V1_.jpg,"Drama, Mystery, Sci-Fi"
1422,The Rock,1260,1605,-345,https://www.imdb.com/title/tt0117500/,https://m.media-amazon.com/images/M/MV5BZDJjOTE0N2EtMmRlZS00NzU0LWE0ZWQtM2Q3MWMxNjcwZjBhXkEyXkFqcGdeQXVyNDk3NzU2MTQ@._V1_.jpg,"Action, Adventure, Thriller"
1425,The English Patient,1460,1018,442,https://www.imdb.com/title/tt0116209/,https://m.media-amazon.com/images/M/MV5BOTkxZTdkNTQtM2QwOS00NzRlLWEyMGItYTcxOTE4NTgyNGVhXkEyXkFqcGdeQXVyMTQxNzMzNDI@._V1_.jpg,"Drama, Romance, War"
1432,Dracula,1222,1040,182,https://www.imdb.com/title/tt0103874/,https://m.media-amazon.com/images/M/MV5BNjcyMDZlMTktYTIxOC00ZWFhLWJkYzgtNWNiYjAwYTFkNjIyXkEyXkFqcGdeQXVyNTIzOTk5ODM@._V1_.jpg,"Fantasy, Horror, Romance"
1433,Back to the Future Part III,1232,1484,-252,https://www.imdb.com/title/tt0099088/,https://m.media-amazon.com/images/M/MV5BYjhlMGYxNmMtOWFmMi00Y2M2LWE5NWYtZTdlMDRlMGEzMDA3XkEyXkFqcGdeQXVyMTQxNzMzNDI@._V1_.jpg,"Adventure, Comedy, Sci-Fi"
1436,Wall Street,1359,1924,-565,https://www.imdb.com/title/tt0094291/,https://m.media-amazon.com/images/M/MV5BNmEyZGQ4NDQtNTEzZC00MDczLWE4ZTEtYTg0ODg2NTkyMWM3XkEyXkFqcGdeQXVyNjU0OTQ0OTY@._V1_.jpg,"Crime, Drama"
1438,Labyrinth,1692,574,1118,https://www.imdb.com/title/tt0091369/,https://m.media-amazon.com/images/M/MV5BMjM2MDE4OTQwOV5BMl5BanBnXkFtZTgwNjgxMTg2NzE@._V1_.jpg,"Adventure, Family, Fantasy"
1440,The NeverEnding Story,1527,894,633,https://www.imdb.com/title/tt0088323/,https://m.media-amazon.com/images/M/MV5BM2YwNWExYjItODZmOC00MTRjLWFlYmEtODFmNGI5M2E5NzYxXkEyXkFqcGdeQXVyMTMxODk2OTU@._V1_.jpg,"Adventure, Drama, Family"
1457,Eraserhead,1433,1697,-264,https://www.imdb.com/title/tt0074486/,https://m.media-amazon.com/images/M/MV5BMDExYzg5YjQtMzE0Yy00OWJjLThiZTctMWI5MzhjM2RmNjA4L2ltYWdlXkEyXkFqcGdeQXVyNTAyODkwOQ@@._V1_.jpg,"Fantasy, Horror"
1458,Carrie,1390,1412,-22,https://www.imdb.com/title/tt0074285/,https://m.media-amazon.com/images/M/MV5BMTlhNmVkZGUtNjdjOC00YWY3LTljZWQtMTY1YWFhNGYwNDQwXkEyXkFqcGdeQXVyNjc1NTYyMjg@._V1_.jpg,"Horror, Mystery"
1461,The Rocky Horror Picture Show,1791,514,1277,https://www.imdb.com/title/tt0073629/,https://m.media-amazon.com/images/M/MV5BOGIzYjM3YzMtMjk5ZS00NDY2LTllMjEtNjYwZjhmMDNhMDBkXkEyXkFqcGdeQXVyODUzMjQxMTA@._V1_.jpg,"Comedy, Horror, Musical"
1473,From Russia with Love,1280,1868,-588,https://www.imdb.com/title/tt0057076/,https://m.media-amazon.com/images/M/MV5BMDU5ZWMxZjctZWNjNi00OGYxLWI0MDEtZmJhYTJkMmEyMTIyXkEyXkFqcGdeQXVyMjUzOTY1NTc@._V1_.jpg,"Action, Adventure, Thriller"
1477,Alice in Wonderland,1555,1072,483,https://www.imdb.com/title/tt0043274/,https://m.media-amazon.com/images/M/MV5BMTgyMjM2NTAxMF5BMl5BanBnXkFtZTgwNjU1NDc2MTE@._V1_.jpg,"Animation, Adventure, Comedy"
1479,Pinocchio,1100,1741,-641,https://www.imdb.com/title/tt0032910/,https://m.media-amazon.com/images/M/MV5BMTU4Mzk3ODIyOF5BMl5BanBnXkFtZTgwODgyNzk2NjE@._V1_.jpg,"Animation, Adventure, Comedy"
1480,El Camino: A Breaking Bad Movie,1533,1849,-316,https://www.imdb.com/title/tt9243946/,https://m.media-amazon.com/images/M/MV5BNjk4MzVlM2UtZGM0ZC00M2M1LThkMWEtZjUyN2U2ZTc0NmM5XkEyXkFqcGdeQXVyOTAzMTc2MjA@._V1_.jpg,"Action, Crime, Drama"
1483,Hereditary,1508,1965,-457,https://www.imdb.com/title/tt7784604/,https://m.media-amazon.com/images/M/MV5BOTU5MDg3OGItZWQ1Ny00ZGVmLTg2YTUtMzBkYzQ1YWIwZjlhXkEyXkFqcGdeQXVyNTAzMTY4MDA@._V1_.jpg,"Drama, Horror, Mystery"
1485,The Ballad of Buster Scruggs,1600,1787,-187,https://www.imdb.com/title/tt6412452/,https://m.media-amazon.com/images/M/MV5BYjRkYTI3M2EtZWQ4Ny00OTA2LWFmMTMtY2E4MTEyZmNjOTMxXkEyXkFqcGdeQXVyNDg4NjY5OTQ@._V1_.jpg,"Comedy, Drama, Musical"
1487,Doctor Sleep,1492,1628,-136,https://www.imdb.com/title/tt5606664/,https://m.media-amazon.com/images/M/MV5BYmY3NGJlYTItYmQ4OS00ZTEwLWIzODItMjMzNWU2MDE0NjZhXkEyXkFqcGdeQXVyMzQzMDA3MTI@._V1_.jpg,"Drama, Fantasy, Horror"
1488,The Shape of Water,1553,1534,19,https://www.imdb.com/title/tt5580390/,https://m.media-amazon.com/images/M/MV5BNGNiNWQ5M2MtNGI0OC00MDA2LWI5NzEtMmZiYjVjMDEyOWYzXkEyXkFqcGdeQXVyMjM4NTM5NDY@._V1_.jpg,"Drama, Fantasy, Romance"
1491,Split,1491,1391,100,https://www.imdb.com/title/tt4972582/,https://m.media-amazon.com/images/M/MV5BZTJiNGM2NjItNDRiYy00ZjY0LTgwNTItZDBmZGRlODQ4YThkL2ltYWdlXkEyXkFqcGdeQXVyMjY5ODI4NDk@._V1_.jpg,"Horror, Thriller"
1495,13 Hours,1639,1248,391,https://www.imdb.com/title/tt4172430/,https://m.media-amazon.com/images/M/MV5BYjY0OWVjMGQtNTIzZi00OGU5LWI4N2EtMGU0YzQ4OWM4ZmVhXkEyXkFqcGdeQXVyMTMxODk2OTU@._V1_.jpg,"Action, Drama, History"
1496,The Lego Batman Movie,1607,1508,99,https://www.imdb.com/title/tt4116284/,https://m.media-amazon.com/images/M/MV5BMTcyNTEyOTY0M15BMl5BanBnXkFtZTgwOTAyNzU3MDI@._V1_.jpg,"Animation, Action, Adventure"
1497,Okja,1658,1117,541,https://www.imdb.com/title/tt3967856/,https://m.media-amazon.com/images/M/MV5BMjQxMTcxNDgxN15BMl5BanBnXkFtZTgwOTczNTIzMjI@._V1_.jpg,"Action, Adventure, Drama"
1498,Snowden,1676,1519,157,https://www.imdb.com/title/tt3774114/,https://m.media-amazon.com/images/M/MV5BMTg2MzYzNzgzOF5BMl5BanBnXkFtZTgwOTg4NzQ4OTE@._V1_.jpg,"Biography, Crime, Drama"
1500,The Walk,1601,1675,-74,https://www.imdb.com/title/tt3488710/,https://m.media-amazon.com/images/M/MV5BNTY4MzA4Mzc5Nl5BMl5BanBnXkFtZTgwNDIzMzk5NjE@._V1_.jpg,"Adventure, Biography, Drama"
1505,Fantastic Beasts and Where to Find Them,1804,887,917,https://www.imdb.com/title/tt3183660/,https://m.media-amazon.com/images/M/MV5BMjMxOTM1OTI4MV5BMl5BanBnXkFtZTgwODE5OTYxMDI@._V1_.jpg,"Adventure, Family, Fantasy"
1506,The Conjuring 2,1590,1637,-47,https://www.imdb.com/title/tt3065204/,https://m.media-amazon.com/images/M/MV5BZjU5OWVlN2EtODNlYy00MjhhLWI0MDUtMTA3MmQ5MGMwYTZmXkEyXkFqcGdeQXVyNjE5MTM4MzY@._V1_.jpg,"Horror, Mystery, Thriller"
1508,Chef,1615,1673,-58,https://www.imdb.com/title/tt2883512/,https://m.media-amazon.com/images/M/MV5BYTQyNDQwMjYtZTY5YS00MGU2LWE5NzctMjM4Y2IyYjkwMjNkXkEyXkFqcGdeQXVyMTY5Nzc4MDY@._V1_.jpg,"Adventure, Comedy, Drama"
1515,Avengers: Age of Ultron,1665,1071,594,https://www.imdb.com/title/tt2395427/,https://m.media-amazon.com/images/M/MV5BMTM4OGJmNWMtOTM4Ni00NTE3LTg3MDItZmQxYjc4N2JhNmUxXkEyXkFqcGdeQXVyNTgzMDMzMTg@._V1_.jpg,"Action, Adventure, Sci-Fi"
1516,Blue Jasmine,1638,1579,59,https://www.imdb.com/title/tt2334873/,https://m.media-amazon.com/images/M/MV5BMTc0ODk5MzEyMV5BMl5BanBnXkFtZTcwMzI0MDY1OQ@@._V1_.jpg,"Comedy, Drama, Romance"
1517,Finding Dory,1684,1080,604,https://www.imdb.com/title/tt2277860/,https://m.media-amazon.com/images/M/MV5BYWVmYTcwZDYtYzNmNC00M2U2LWFjZWYtOWRlY2NiNjc5ZjdiXkEyXkFqcGdeQXVyNjY5Mjg5MjA@._V1_.jpg,"Animation, Adventure, Comedy"
1519,American Sniper,1628,1612,16,https://www.imdb.com/title/tt2179136/,https://m.media-amazon.com/images/M/MV5BMTkxNzI3ODI4Nl5BMl5BanBnXkFtZTgwMjkwMjY4MjE@._V1_.jpg,"Action, Biography, Drama"
1520,The Accountant,1475,1502,-27,https://www.imdb.com/title/tt2140479/,https://m.media-amazon.com/images/M/MV5BNDc5Mzg2NTYxNV5BMl5BanBnXkFtZTgwMjQ2ODAwOTE@._V1_.jpg,"Action, Crime, Drama"
1523,Rocketman,1748,1070,678,https://www.imdb.com/title/tt2066051/,https://m.media-amazon.com/images/M/MV5BYmIzNjUxZGQtYjg0OS00MmE0LTgwZDAtMzVmODQ2MGI5MTQ5XkEyXkFqcGdeQXVyMTA3MTA4Mzgw._V1_.jpg,"Biography, Drama, Music"
1525,Flight,1452,1847,-395,https://www.imdb.com/title/tt1907668/,https://m.media-amazon.com/images/M/MV5BMTUxMjI1OTMxNl5BMl5BanBnXkFtZTcwNjc3NTY1OA@@._V1_.jpg,"Drama, Thriller"
1526,The Edge of Seventeen,1486,1645,-159,https://www.imdb.com/title/tt1878870/,https://m.media-amazon.com/images/M/MV5BODE2NjE4NjYyMV5BMl5BanBnXkFtZTgwNzk3MjQ0OTE@._V1_.jpg,"Comedy, Drama"
1527,Black Panther,1844,789,1055,https://www.imdb.com/title/tt1825683/,https://m.media-amazon.com/images/M/MV5BMTg1MTY2MjYzNV5BMl5BanBnXkFtZTgwMTc4NTMwNDI@._V1_.jpg,"Action, Adventure, Sci-Fi"
1528,The Place Beyond the Pines,1412,1763,-351,https://www.imdb.com/title/tt1817273/,https://m.media-amazon.com/images/M/MV5BMjc1OTEwNjU4N15BMl5BanBnXkFtZTcwNzUzNDIwOQ@@._V1_.jpg,"Crime, Drama, Thriller"
1530,Despicable Me 2,1637,1044,593,https://www.imdb.com/title/tt1690953/,https://m.media-amazon.com/images/M/MV5BMTQxNzY1MjI5NF5BMl5BanBnXkFtZTcwNTI0MDY1OQ@@._V1_.jpg,"Animation, Adventure, Comedy"
1531,Now You See Me,1777,1101,676,https://www.imdb.com/title/tt1670345/,https://m.media-amazon.com/images/M/MV5BMTY0NDY3MDMxN15BMl5BanBnXkFtZTcwOTM5NzMzOQ@@._V1_.jpg,"Crime, Mystery, Thriller"
1532,The Man from U.N.C.L.E.,1681,1164,517,https://www.imdb.com/title/tt1638355/,https://m.media-amazon.com/images/M/MV5BOTZmMWFhYmQtZDE5YS00YzBlLWJlOGEtYzAwNGU1YzVlYjZlXkEyXkFqcGdeQXVyNzkwMjQ5NzM@._V1_.jpg,"Action, Adventure, Comedy"
1533,Fast Five,1580,1180,400,https://www.imdb.com/title/tt1596343/,https://m.media-amazon.com/images/M/MV5BMTUxNTk5MTE0OF5BMl5BanBnXkFtZTcwMjA2NzY3NA@@._V1_.jpg,"Action, Crime, Thriller"
1535,The Next Three Days,1343,1595,-252,https://www.imdb.com/title/tt1458175/,https://m.media-amazon.com/images/M/MV5BMjA3NTY5ODI4OV5BMl5BanBnXkFtZTcwMjcxNzQ5Mw@@._V1_.jpg,"Action, Crime, Drama"
1536,Monsters University,1713,1303,410,https://www.imdb.com/title/tt1453405/,https://m.media-amazon.com/images/M/MV5BMTUyODgwMDU3M15BMl5BanBnXkFtZTcwOTM4MjcxOQ@@._V1_.jpg,"Animation, Adventure, Comedy"
1537,Rise of the Guardians,1917,623,1294,https://www.imdb.com/title/tt1446192/,https://m.media-amazon.com/images/M/MV5BMTkzMjgwMDg1M15BMl5BanBnXkFtZTcwMTgzNTI1OA@@._V1_.jpg,"Animation, Action, Adventure"
1542,It,1484,1592,-108,https://www.imdb.com/title/tt1396484/,https://m.media-amazon.com/images/M/MV5BZDVkZmI0YzAtNzdjYi00ZjhhLWE1ODEtMWMzMWMzNDA0NmQ4XkEyXkFqcGdeQXVyNzYzODM3Mzg@._V1_.jpg,"Fantasy, Horror"
1551,First Man,1584,1903,-319,https://www.imdb.com/title/tt1213641/,https://m.media-amazon.com/images/M/MV5BMDBhOTMxN2UtYjllYS00NWNiLWE1MzAtZjg3NmExODliMDQ0XkEyXkFqcGdeQXVyMjMxOTE0ODA@._V1_.jpg,"Biography, Drama, History"
1552,Lawless,1661,1444,217,https://www.imdb.com/title/tt1212450/,https://m.media-amazon.com/images/M/MV5BMjAxNjUyNjUwN15BMl5BanBnXkFtZTcwMDgwOTIyOA@@._V1_.jpg,"Biography, Crime, Drama"
1554,The Lincoln Lawyer,1466,1431,35,https://www.imdb.com/title/tt1189340/,https://m.media-amazon.com/images/M/MV5BMTQ4NDE4NTY5MV5BMl5BanBnXkFtZTcwODQyMTkxNA@@._V1_.jpg,"Crime, Drama, Mystery"
1555,An Education,1710,1406,304,https://www.imdb.com/title/tt1174732/,https://m.media-amazon.com/images/M/MV5BMTg4NjgzOTc0MF5BMl5BanBnXkFtZTcwOTc2OTE3Mg@@._V1_.jpg,Drama
1557,Invictus,1505,1397,108,https://www.imdb.com/title/tt1057500/,https://m.media-amazon.com/images/M/MV5BMjAyMzExMDM1N15BMl5BanBnXkFtZTcwNTcyMTQ5Mg@@._V1_.jpg,"Biography, Drama, History"
1558,The Descendants,1429,1833,-404,https://www.imdb.com/title/tt1033575/,https://m.media-amazon.com/images/M/MV5BMjAyNTA1MTcyN15BMl5BanBnXkFtZTcwNjEyODczNQ@@._V1_.jpg,"Comedy, Drama"
1559,RocknRolla,1507,1427,80,https://www.imdb.com/title/tt1032755/,https://m.media-amazon.com/images/M/MV5BMTQ0NTk5Mzk2OV5BMl5BanBnXkFtZTcwMDE3NTE4MQ@@._V1_.jpg,"Action, Crime, Thriller"
1561,The Way Back,1516,1378,138,https://www.imdb.com/title/tt1023114/,https://m.media-amazon.com/images/M/MV5BMTg5MTc5MTM3Ml5BMl5BanBnXkFtZTcwMDI2NzgwNA@@._V1_.jpg,"Adventure, Drama, History"
1562,The Adventures of Tintin: The Secret of the Unicorn,1440,1750,-310,https://www.imdb.com/title/tt0983193/,https://m.media-amazon.com/images/M/MV5BNDE5MDExNTQ1OF5BMl5BanBnXkFtZTcwMDIxMTM5Ng@@._V1_.jpg,"Animation, Action, Adventure"
1564,Revolutionary Road,1556,1539,17,https://www.imdb.com/title/tt0959337/,https://m.media-amazon.com/images/M/MV5BMTczNDgzMjczOV5BMl5BanBnXkFtZTcwOTU3MzMwMg@@._V1_.jpg,"Drama, Romance"
1565,Precious,1700,1218,482,https://www.imdb.com/title/tt0929632/,https://m.media-amazon.com/images/M/MV5BNjNhNDgxNzgtYTYxZS00NjIxLTk2YzYtNTFkMDIyOGI5NGU0XkEyXkFqcGdeQXVyNTIzOTk5ODM@._V1_.jpg,Drama
1567,Lars and the Real Girl,1512,1297,215,https://www.imdb.com/title/tt0805564/,https://m.media-amazon.com/images/M/MV5BMGY5YmMwNmUtNmNhMy00ZjE1LWI3NDQtZTQ1NzEzZGM5NTI3XkEyXkFqcGdeQXVyMTMxMTY0OTQ@._V1_.jpg,"Comedy, Drama, Romance"
1569,Mr. Brooks,1397,1791,-394,https://www.imdb.com/title/tt0780571/,https://m.media-amazon.com/images/M/MV5BMTQyNTk5MTMxN15BMl5BanBnXkFtZTcwNTc0ODI1NA@@._V1_.jpg,"Crime, Drama, Mystery"
1570,Ant-Man,1627,1545,82,https://www.imdb.com/title/tt0478970/,https://m.media-amazon.com/images/M/MV5BMjM2NTQ5Mzc2M15BMl5BanBnXkFtZTgwNTcxMDI2NTE@._V1_.jpg,"Action, Comedy, Sci-Fi"
1572,The Simpsons Movie,1510,1871,-361,https://www.imdb.com/title/tt0462538/,https://m.media-amazon.com/images/M/MV5BN2I0MmE5N2ItMWJkOS00NTU4LTg4ZDctMGJiNDdkM2E4MDU3XkEyXkFqcGdeQXVyMTU2OTg4NjIy._V1_.jpg,"Animation, Adventure, Comedy"
1573,Rescue Dawn,1560,1650,-90,https://www.imdb.com/title/tt0462504/,https://m.media-amazon.com/images/M/MV5BNzUxNzUzNzU2MV5BMl5BanBnXkFtZTcwNTgzNzU2NA@@._V1_.jpg,"Adventure, Biography, War"
1574,Across the Universe,1738,997,741,https://www.imdb.com/title/tt0445922/,https://m.media-amazon.com/images/M/MV5BMDViYjYzMTctNDFlNS00NmFmLWJlMGUtZDFmZmFjY2Q2ODhjXkEyXkFqcGdeQXVyMTU3NDU4MDg2._V1_.jpg,"Drama, Fantasy, History"
1575,Borat: Cultural Learnings of America for Make Benefit Glorious Nation of Kazakhstan,1495,1998,-503,https://www.imdb.com/title/tt0443453/,https://m.media-amazon.com/images/M/MV5BMTk0MTQ3NDQ4Ml5BMl5BanBnXkFtZTcwOTQ3OTQzMw@@._V1_.jpg,Comedy
1576,Lincoln,1414,1639,-225,https://www.imdb.com/title/tt0443272/,https://m.media-amazon.com/images/M/MV5BMTQzNzczMDUyNV5BMl5BanBnXkFtZTcwNjM2ODEzOA@@._V1_.jpg,"Biography, Drama, History"
1578,Alita: Battle Angel,1541,1754,-213,https://www.imdb.com/title/tt0437086/,https://m.media-amazon.com/images/M/MV5BMTQzYWYwYjctY2JhZS00NTYzLTllM2UtZWY5ZTk0NmYwYzIyXkEyXkFqcGdeQXVyMzgxODM4NjM@._V1_.jpg,"Action, Adventure, Sci-Fi"
1579,The Queen,1602,1572,30,https://www.imdb.com/title/tt0436697/,https://m.media-amazon.com/images/M/MV5BMTQ3NTMxODg1Ml5BMl5BanBnXkFtZTcwMjEyMjczMQ@@._V1_.jpg,"Biography, Drama"
1580,Clerks II,1422,1922,-500,https://www.imdb.com/title/tt0424345/,https://m.media-amazon.com/images/M/MV5BZTNhNTRmYmYtZGI1YS00NzdjLTg3ZjMtZDM5YmJiMDVjNTFlXkEyXkFqcGdeQXVyNTAyODkwOQ@@._V1_.jpg,Comedy
1584,Sweeney Todd: The Demon Barber of Fleet Street,1712,1095,617,https://www.imdb.com/title/tt0408236/,https://m.media-amazon.com/images/M/MV5BMTg3NjUxMzM5NV5BMl5BanBnXkFtZTcwMzQ1NjQzMw@@._V1_.jpg,"Drama, Horror, Musical"
1587,Coach Carter,1583,1498,85,https://www.imdb.com/title/tt0393162/,https://m.media-amazon.com/images/M/MV5BNWYxZWFiNTItN2FkNS00ZDJmLWE1MWItYjMyMTgyOTI4MmQ4XkEyXkFqcGdeQXVyMTQxNzMzNDI@._V1_.jpg,"Biography, Drama, Sport"
1588,Brick,1653,1902,-249,https://www.imdb.com/title/tt0393109/,https://m.media-amazon.com/images/M/MV5BMTk4MjQzMzA2N15BMl5BanBnXkFtZTcwMTU2MzIzMQ@@._V1_.jpg,"Crime, Drama, Mystery"
1590,Pirates of the Caribbean: Dead Man's Chest,1589,1183,406,https://www.imdb.com/title/tt0383574/,https://m.media-amazon.com/images/M/MV5BMTcwODc1MTMxM15BMl5BanBnXkFtZTYwMDg1NzY3._V1_.jpg,"Action, Adventure, Fantasy"
1591,Capote,1449,1352,97,https://www.imdb.com/title/tt0379725/,https://m.media-amazon.com/images/M/MV5BMTczMzU0MjM1MV5BMl5BanBnXkFtZTcwMjczNzgyNA@@._V1_.jpg,"Biography, Crime, Drama"
1592,Layer Cake,1523,1937,-414,https://www.imdb.com/title/tt0375912/,https://m.media-amazon.com/images/M/MV5BMTI5MTE1OTAzOV5BMl5BanBnXkFtZTcwNDc2OTgyMQ@@._V1_.jpg,"Action, Crime, Drama"
1594,Dawn of the Dead,495,1226,-731,https://www.imdb.com/title/tt0363547/,https://m.media-amazon.com/images/M/MV5BN2M2ZmU2OGQtNmU5Yi00MTIyLTgwNWMtYjljMzZlYTdiNjBhXkEyXkFqcGdeQXVyNTAyODkwOQ@@._V1_.jpg,"Action, Horror"
1595,The Life Aquatic with Steve Zissou,1526,1713,-187,https://www.imdb.com/title/tt0362270/,https://m.media-amazon.com/images/M/MV5BMTYzODYzNzg2MF5BMl5BanBnXkFtZTcwMTkzOTQzMw@@._V1_.jpg,"Action, Adventure, Comedy"
1596,The Secret Life of Walter Mitty,1455,1425,30,https://www.imdb.com/title/tt0359950/,https://m.media-amazon.com/images/M/MV5BODYwNDYxNDk1Nl5BMl5BanBnXkFtZTgwOTAwMTk2MDE@._V1_.jpg,"Adventure, Comedy, Drama"
1598,Monster,1660,1407,253,https://www.imdb.com/title/tt0340855/,https://m.media-amazon.com/images/M/MV5BMTI4NzI5NzEwNl5BMl5BanBnXkFtZTcwNjc1NjQyMQ@@._V1_.jpg,"Biography, Crime, Drama"
1599,Troy,1670,1863,-193,https://www.imdb.com/title/tt0332452/,https://m.media-amazon.com/images/M/MV5BMTk5MzU1MDMwMF5BMl5BanBnXkFtZTcwNjczODMzMw@@._V1_.jpg,"Adventure, Drama"
1601,Matchstick Men,1596,1826,-230,https://www.imdb.com/title/tt0325805/,https://m.media-amazon.com/images/M/MV5BMjA3NjMyNjIyMF5BMl5BanBnXkFtZTYwOTgzMDI3._V1_.jpg,"Comedy, Crime, Drama"
1602,Spider-Man 2,1529,1981,-452,https://www.imdb.com/title/tt0316654/,https://m.media-amazon.com/images/M/MV5BMzY2ODk4NmUtOTVmNi00ZTdkLTlmOWYtMmE2OWVhNTU2OTVkXkEyXkFqcGdeQXVyMTQxNzMzNDI@._V1_.jpg,"Action, Adventure, Sci-Fi"
1603,Identity,1554,1450,104,https://www.imdb.com/title/tt0309698/,https://m.media-amazon.com/images/M/MV5BMjE2NzgyNDYzNl5BMl5BanBnXkFtZTYwODM2Nzc2._V1_.jpg,"Mystery, Thriller"
1610,Punch-Drunk Love,1550,1997,-447,https://www.imdb.com/title/tt0272338/,https://m.media-amazon.com/images/M/MV5BYmE1OTY4NjgtYjcwNC00NWE4LWJiNGMtZmVhYTdlMWE1YzIxXkEyXkFqcGdeQXVyMTMxODk2OTU@._V1_.jpg,"Comedy, Drama, Romance"
1611,Unbreakable,1511,1936,-425,https://www.imdb.com/title/tt0217869/,https://m.media-amazon.com/images/M/MV5BMDIwMjAxNzktNmEzYS00ZDY5LWEyZjktM2Y0MmUzZDkyYmZkXkEyXkFqcGdeQXVyNTA4NzY1MzY@._V1_.jpg,"Drama, Mystery, Sci-Fi"
1613,Frequency,1501,1162,339,https://www.imdb.com/title/tt0186151/,https://m.media-amazon.com/images/M/MV5BOGE1YTBjMjgtNTM5NS00YTk0LWEzOTQtMjk1NWY0ZWI1NDY3XkEyXkFqcGdeQXVyMTUzMDUzNTI3._V1_.jpg,"Crime, Drama, Mystery"
1616,Galaxy Quest,1515,1161,354,https://www.imdb.com/title/tt0177789/,https://m.media-amazon.com/images/M/MV5BNmZlNTY5YjQtZTU5ZC00MzcyLWI1NDMtNjA0ZjQxMmQwYjJmL2ltYWdlXkEyXkFqcGdeQXVyNTAyODkwOQ@@._V1_.jpg,"Adventure, Comedy, Sci-Fi"
1617,"Girl, Interrupted",1898,806,1092,https://www.imdb.com/title/tt0172493/,https://m.media-amazon.com/images/M/MV5BNzdjZDYwM2QtMGNlZS00MGQzLTlhMjctYTU4NWI5MWJlYmQwXkEyXkFqcGdeQXVyMTAwMzUyOTc@._V1_.jpg,"Biography, Drama"
1620,Sleepy Hollow,1517,1274,243,https://www.imdb.com/title/tt0162661/,https://m.media-amazon.com/images/M/MV5BMTQ4Yjk5ODEtNGFkOS00OTY1LTgwYTYtOTFkNmU2NzBmNGM2XkEyXkFqcGdeQXVyNDQ2MTMzODA@._V1_.jpg,"Fantasy, Horror, Mystery"
1621,Ghost World,1521,1647,-126,https://www.imdb.com/title/tt0162346/,https://m.media-amazon.com/images/M/MV5BNWYwODRlYjgtODUxNy00YmMyLWE3NWYtNTYzZmUwNDJiZGVlXkEyXkFqcGdeQXVyMTQxNzMzNDI@._V1_.jpg,"Comedy, Drama"
1622,10 Things I Hate About You,1985,856,1129,https://www.imdb.com/title/tt0147800/,https://m.media-amazon.com/images/M/MV5BMmVhZjhlZDYtMDAwZi00MDcyLTgzOTItOWNiZjY0YmE0MGE0XkEyXkFqcGdeQXVyMTQxNzMzNDI@._V1_.jpg,"Comedy, Drama, Romance"
1624,Spider-Man,1535,1906,-371,https://www.imdb.com/title/tt0145487/,https://m.media-amazon.com/images/M/MV5BZDEyN2NhMjgtMjdhNi00MmNlLWE5YTgtZGE4MzNjMTRlMGEwXkEyXkFqcGdeQXVyNDUyOTg3Njg@._V1_.jpg,"Action, Adventure, Sci-Fi"
1625,Rounders,1379,1973,-594,https://www.imdb.com/title/tt0128442/,https://m.media-amazon.com/images/M/MV5BMzViMmMxMzItYmYyYi00NGU3LWI2MDMtNjcwOWFmZTZkOTcwXkEyXkFqcGdeQXVyNDkzNTM2ODg@._V1_.jpg,"Crime, Drama"
1626,Ronin,1558,1964,-406,https://www.imdb.com/title/tt0122690/,https://m.media-amazon.com/images/M/MV5BOWVkYzliZGEtODIxMi00MDQwLThjMDAtNzI3M2NjYjg4NDE5XkEyXkFqcGdeQXVyNjU0OTQ0OTY@._V1_.jpg,"Action, Crime, Thriller"
1627,Corpse Bride,1691,941,750,https://www.imdb.com/title/tt0121164/,https://m.media-amazon.com/images/M/MV5BMTk1MTY1NjU4MF5BMl5BanBnXkFtZTcwNjIzMTEzMw@@._V1_.jpg,"Animation, Comedy, Drama"
1628,Tarzan,1800,1433,367,https://www.imdb.com/title/tt0120855/,https://m.media-amazon.com/images/M/MV5BY2ZiYWUxN2ItYmQxZi00NDlkLWE2NDAtOTNmYTg1MDI0NDk1XkEyXkFqcGdeQXVyNjUwNzk3NDc@._V1_.jpg,"Animation, Adventure, Comedy"
1629,The Negotiator,1569,1618,-49,https://www.imdb.com/title/tt0120768/,https://m.media-amazon.com/images/M/MV5BOGE1YTI2NjItNDAyYy00YzI3LTlmNDUtYWU0ZmFlNWE3N2ViL2ltYWdlXkEyXkFqcGdeQXVyNTAyODkwOQ@@._V1_.jpg,"Action, Crime, Drama"
1631,Enemy of the State,1519,1721,-202,https://www.imdb.com/title/tt0120660/,https://m.media-amazon.com/images/M/MV5BMWI0Y2NhMzMtYTE5ZS00MDlhLTg0ZjEtMjAwZmEwNTc0ODc2XkEyXkFqcGdeQXVyNjU0OTQ0OTY@._V1_.jpg,"Action, Thriller"
1632,Dogma,1617,1275,342,https://www.imdb.com/title/tt0120655/,https://m.media-amazon.com/images/M/MV5BNDQxMTRlYzMtMzQ0ZC00MDJjLWE0YTgtZTAxMmI0MzY2MjVhXkEyXkFqcGdeQXVyNTI4MjkwNjA@._V1_.jpg,"Adventure, Comedy, Drama"
1633,Men in Black,1463,1666,-203,https://www.imdb.com/title/tt0119654/,https://m.media-amazon.com/images/M/MV5BOTlhYTVkMDktYzIyNC00NzlkLTlmN2ItOGEyMWQ4OTA2NDdmXkEyXkFqcGdeQXVyNTAyODkwOQ@@._V1_.jpg,"Action, Adventure, Comedy"
1634,Hercules,1856,1159,697,https://www.imdb.com/title/tt0119282/,https://m.media-amazon.com/images/M/MV5BZDcwYjEyNWItMGI1Mi00MjI1LWIyMDEtMTQ4YjhkNjM4NDU3XkEyXkFqcGdeQXVyNDUyOTg3Njg@._V1_.jpg,"Animation, Action, Adventure"
1637,Scream,1695,1725,-30,https://www.imdb.com/title/tt0117571/,https://m.media-amazon.com/images/M/MV5BMjA2NjU5MTg5OF5BMl5BanBnXkFtZTgwOTkyMzQxMDE@._V1_.jpg,"Horror, Mystery"
1639,Jerry Maguire,1543,1874,-331,https://www.imdb.com/title/tt0116695/,https://m.media-amazon.com/images/M/MV5BYTM0ZWNmZTUtOTVkZS00MTZiLTg3M2QtZjA0Y2RmOWM1NWEyXkEyXkFqcGdeQXVyNjU0OTQ0OTY@._V1_.jpg,"Comedy, Drama, Romance"
1643,Friday,1551,1587,-36,https://www.imdb.com/title/tt0113118/,https://m.media-amazon.com/images/M/MV5BYmEwNjNlZTUtNzkwMS00ZTlhLTkyY2MtMjM2MzlmODQyZGVhXkEyXkFqcGdeQXVyNTI4MjkwNjA@._V1_.jpg,"Comedy, Drama"
1644,Crimson Tide,1493,1786,-293,https://www.imdb.com/title/tt0112740/,https://m.media-amazon.com/images/M/MV5BMmFkY2IxNTAtMWRiNS00MWU2LWI1NDYtY2YxYTQyYTk5OTBhXkEyXkFqcGdeQXVyNDk3NzU2MTQ@._V1_.jpg,"Action, Drama, Thriller"
1645,The Basketball Diaries,1524,1316,208,https://www.imdb.com/title/tt0112461/,https://m.media-amazon.com/images/M/MV5BMjdlNzQxZGUtZTg5YS00ODg2LTkxMzctMDAyNmEwM2YyZjA4XkEyXkFqcGdeQXVyMTQxNzMzNDI@._V1_.jpg,"Biography, Crime, Drama"
1647,Natural Born Killers,1598,1206,392,https://www.imdb.com/title/tt0110632/,https://m.media-amazon.com/images/M/MV5BNGNjNjU1YmEtZGM5MC00ODgzLWEyY2MtZmZmNTlhOGU4OWJjXkEyXkFqcGdeQXVyNTAyODkwOQ@@._V1_.jpg,"Action, Crime, Romance"
1651,Dumb and Dumber,1335,1999,-664,https://www.imdb.com/title/tt0109686/,https://m.media-amazon.com/images/M/MV5BZDQwMjNiMTQtY2UwYy00NjhiLTk0ZWEtZWM5ZWMzNGFjNTVkXkEyXkFqcGdeQXVyMTQxNzMzNDI@._V1_.jpg,Comedy
1659,Point Break,1566,1719,-153,https://www.imdb.com/title/tt0102685/,https://m.media-amazon.com/images/M/MV5BNWVjZWFmYjItZGJlOC00YTllLWE4YjctMWY2ZTg5ZjE0MDIyXkEyXkFqcGdeQXVyNDk3NzU2MTQ@._V1_.jpg,"Action, Crime, Thriller"
1660,Cape Fear,713,700,13,https://www.imdb.com/title/tt0101540/,https://m.media-amazon.com/images/M/MV5BNjdhNzZlYzYtYTBlNS00NTJiLWI2ZWUtMDI2YzI2MzM5NjY4XkEyXkFqcGdeQXVyNjc1NTYyMjg@._V1_.jpg,"Crime, Thriller"
1665,Driving Miss Daisy,1444,1217,227,https://www.imdb.com/title/tt0097239/,https://m.media-amazon.com/images/M/MV5BMDE2ZTY3YmUtZTFhYy00ZmU2LWI2NjktY2NmZGZlYjg5OGMwXkEyXkFqcGdeQXVyMTQxNzMzNDI@._V1_.jpg,"Comedy, Drama"
1666,Willow,1682,1136,546,https://www.imdb.com/title/tt0096446/,https://m.media-amazon.com/images/M/MV5BNTliMTA3ZTUtYzJkMC00M2UzLTllYmItNjc1MzFhOTJmMmJjXkEyXkFqcGdeQXVyOTYyMTY2NzQ@._V1_.jpg,"Action, Adventure, Drama"
1668,They Live,1568,1793,-225,https://www.imdb.com/title/tt0096256/,https://m.media-amazon.com/images/M/MV5BMTQ3MjM3ODU1NV5BMl5BanBnXkFtZTgwMjU3NDU2MTE@._V1_.jpg,"Action, Horror, Sci-Fi"
1670,Big,1480,1553,-73,https://www.imdb.com/title/tt0094737/,https://m.media-amazon.com/images/M/MV5BMDQ1ODM5MTMtMjAwYi00ZGUxLTliNTMtN2ZhODAwMjVhMTRlXkEyXkFqcGdeQXVyNTAyODkwOQ@@._V1_.jpg,"Comedy, Drama, Fantasy"
1671,Raising Arizona,1393,1726,-333,https://www.imdb.com/title/tt0093822/,https://m.media-amazon.com/images/M/MV5BOGUwZTEwZTYtZmQ0OS00NmM1LWE2ZTQtNjZiYmE4ZmUxMjk1XkEyXkFqcGdeQXVyMTQxNzMzNDI@._V1_.jpg,"Comedy, Crime"
1672,The Lost Boys,1835,1112,723,https://www.imdb.com/title/tt0093437/,https://m.media-amazon.com/images/M/MV5BMWEzNmUxZTMtZjY0My00OGNmLWIyNDctODM2YzZjM2YwZWEwXkEyXkFqcGdeQXVyMTQxNzMzNDI@._V1_.jpg,"Comedy, Horror"
1673,"Good Morning, Vietnam",1443,1386,57,https://www.imdb.com/title/tt0093105/,https://m.media-amazon.com/images/M/MV5BOWRhZGQ5ODQtMzUzNi00M2I4LThmZmUtYmQ0NDQzMTkxMWQ0XkEyXkFqcGdeQXVyMzI0NDc4ODY@._V1_.jpg,"Biography, Comedy, Drama"
1678,Big Trouble in Little China,1546,1888,-342,https://www.imdb.com/title/tt0090728/,https://m.media-amazon.com/images/M/MV5BNzlhYjEzOGItN2MwNS00ODRiLWE5OTItYThiNmJlMTdmMzgxXkEyXkFqcGdeQXVyNTAyODkwOQ@@._V1_.jpg,"Action, Adventure, Comedy"
1683,The Karate Kid,1651,1739,-88,https://www.imdb.com/title/tt0087538/,https://m.media-amazon.com/images/M/MV5BNTkzY2YzNmYtY2ViMS00MThiLWFlYTEtOWQ1OTBiOGEwMTdhXkEyXkFqcGdeQXVyMTQxNzMzNDI@._V1_.jpg,"Action, Drama, Family"
1684,Gremlins,1572,1800,-228,https://www.imdb.com/title/tt0087363/,https://m.media-amazon.com/images/M/MV5BZDNlZWYyNTctMDk0Ni00MGI2LWFlOTQtY2M0YWZkZDY4ZjJiXkEyXkFqcGdeQXVyNjc5NjEzNA@@._V1_.jpg,"Comedy, Fantasy, Horror"
1685,Beverly Hills Cop,1461,1865,-404,https://www.imdb.com/title/tt0086960/,https://m.media-amazon.com/images/M/MV5BNzU1M2QxMzgtZmJiYy00Zjc4LTg3YTMtZTBmZmNhMDMxZmU2XkEyXkFqcGdeQXVyMTUzMDUzNTI3._V1_.jpg,"Action, Comedy, Crime"
1686,Poltergeist,1399,1570,-171,https://www.imdb.com/title/tt0084516/,https://m.media-amazon.com/images/M/MV5BODJiZTU1ZTMtZTEzMy00NzFmLWJjNzctZTc2MDcwZjE1MDBjXkEyXkFqcGdeQXVyMTUzMDUzNTI3._V1_.jpg,"Horror, Thriller"
1689,Caddyshack,1539,1948,-409,https://www.imdb.com/title/tt0080487/,https://m.media-amazon.com/images/M/MV5BMjhlNzFiNTAtMGY4OC00ODFjLWI2NWQtZDMwNTNlMTJmNGM2XkEyXkFqcGdeQXVyNDUzNzgxODE@._V1_.jpg,"Comedy, Sport"
1690,Rocky II,1685,1917,-232,https://www.imdb.com/title/tt0079817/,https://m.media-amazon.com/images/M/MV5BNjk2Y2FiYWEtNGViNy00ZDNkLThhZGItMDI5YjQ5NGYxYWJmXkEyXkFqcGdeQXVyMjUzOTY1NTc@._V1_.jpg,"Drama, Sport"
1691,Superman,1419,1611,-192,https://www.imdb.com/title/tt0078346/,https://m.media-amazon.com/images/M/MV5BMzA0YWMwMTUtMTVhNC00NjRkLWE2ZTgtOWEzNjJhYzNiMTlkXkEyXkFqcGdeQXVyNjc1NTYyMjg@._V1_.jpg,"Action, Adventure, Sci-Fi"
1698,Easy Rider,1506,1768,-262,https://www.imdb.com/title/tt0064276/,https://m.media-amazon.com/images/M/MV5BMTc2MjI2NDc4Ml5BMl5BanBnXkFtZTgwODI4NzU0MTI@._V1_.jpg,"Adventure, Drama"
1700,One Hundred and One Dalmatians,1864,1169,695,https://www.imdb.com/title/tt0055254/,https://m.media-amazon.com/images/M/MV5BZGMyMjE4OGUtNGZmMC00YzdmLThkMWYtZWIzMmEzNjA4MzVkXkEyXkFqcGdeQXVyMTQxNzMzNDI@._V1_.jpg,"Animation, Adventure, Comedy"
1701,Lady and the Tramp,1847,954,893,https://www.imdb.com/title/tt0048280/,https://m.media-amazon.com/images/M/MV5BYTI1ZDc1OTItM2EzNS00ODMxLWIxYzctOTc5YWNiYzI3NGZiXkEyXkFqcGdeQXVyNDE5MTU2MDE@._V1_.jpg,"Animation, Adventure, Comedy"
1702,Peter Pan,1709,1177,532,https://www.imdb.com/title/tt0046183/,https://m.media-amazon.com/images/M/MV5BMzIwMzUyYTUtMjQ3My00NDc3LWIyZjQtOGUzNDJmNTFlNWUxXkEyXkFqcGdeQXVyMjA0MDQ0Mjc@._V1_.jpg,"Animation, Adventure, Family"
1703,Cinderella,1957,934,1023,https://www.imdb.com/title/tt0042332/,https://m.media-amazon.com/images/M/MV5BODFmMmE3ODItN2VlNi00NWFkLTg1N2EtZTNkMTIyM2IzNWZhXkEyXkFqcGdeQXVyMTE0OTMwOTg@._V1_.jpg,"Animation, Family, Fantasy"
1704,Bambi,1610,1394,216,https://www.imdb.com/title/tt0034492/,https://m.media-amazon.com/images/M/MV5BNTVhMDc3MzYtNzI4Ni00YmNmLTkzM2YtMjBhMGFkODFjOTk4XkEyXkFqcGdeQXVyMTU3NDU4MDg2._V1_.jpg,"Animation, Adventure, Drama"
1708,The Post,1858,1814,44,https://www.imdb.com/title/tt6294822/,https://m.media-amazon.com/images/M/MV5BMjQyMjEwOTIwNV5BMl5BanBnXkFtZTgwOTkzNTMxNDM@._V1_.jpg,"Biography, Drama, History"
1709,Vice,1783,1728,55,https://www.imdb.com/title/tt6266538/,https://m.media-amazon.com/images/M/MV5BMTY1NjM0MzgxMV5BMl5BanBnXkFtZTgwNDc4NTY0NjM@._V1_.jpg,"Biography, Comedy, Drama"
1715,The Founder,1680,1919,-239,https://www.imdb.com/title/tt4276820/,https://m.media-amazon.com/images/M/MV5BMzExNDg0MDk1M15BMl5BanBnXkFtZTgwNzE1Mjg0MDI@._V1_.jpg,"Biography, Drama"
1721,American Made,1852,1932,-80,https://www.imdb.com/title/tt3532216/,https://m.media-amazon.com/images/M/MV5BMTUxNzUwMjk1Nl5BMl5BanBnXkFtZTgwNDkwODI1MjI@._V1_.jpg,"Action, Comedy, Crime"
1722,The Lobster,1910,1873,37,https://www.imdb.com/title/tt3464902/,https://m.media-amazon.com/images/M/MV5BNDQ1NDE5NzQ1NF5BMl5BanBnXkFtZTgwNzA5OTM2NTE@._V1_.jpg,"Drama, Romance, Sci-Fi"
1725,Coherence,1725,1705,20,https://www.imdb.com/title/tt2866360/,https://m.media-amazon.com/images/M/MV5BNzQ3ODUzNDY2M15BMl5BanBnXkFtZTgwNzg0ODY2MTE@._V1_.jpg,"Drama, Mystery, Sci-Fi"
1726,T2 Trainspotting,1827,1655,172,https://www.imdb.com/title/tt2763304/,https://m.media-amazon.com/images/M/MV5BMjI0MTE1ODkzMl5BMl5BanBnXkFtZTgwMTQ1MTg5MDI@._V1_.jpg,"Comedy, Crime, Drama"
1733,Carol,1720,1758,-38,https://www.imdb.com/title/tt2402927/,https://m.media-amazon.com/images/M/MV5BMTczNTQ4OTEyNV5BMl5BanBnXkFtZTgwNDgyMDI3NjE@._V1_.jpg,"Drama, Romance"
1740,Steve Jobs,1765,1979,-214,https://www.imdb.com/title/tt2080374/,https://m.media-amazon.com/images/M/MV5BMjE0NTA2MTEwOV5BMl5BanBnXkFtZTgwNzg4NzU2NjE@._V1_.jpg,"Biography, Drama"
1741,Seven Psychopaths,1830,1704,126,https://www.imdb.com/title/tt1931533/,https://m.media-amazon.com/images/M/MV5BMTgwMzUxMjc0M15BMl5BanBnXkFtZTcwMzQ2MjYyOA@@._V1_.jpg,"Comedy, Crime"
1745,Unbroken,1918,1149,769,https://www.imdb.com/title/tt1809398/,https://m.media-amazon.com/images/M/MV5BMTY3ODg2OTgyOF5BMl5BanBnXkFtZTgwODk1OTAwMzE@._V1_.jpg,"Action, Biography, Drama"
1746,American Hustle,1605,1921,-316,https://www.imdb.com/title/tt1800241/,https://m.media-amazon.com/images/M/MV5BMmM4YzJjZGMtNjQxMy00NjdlLWJjYTItZWZkYzdhOTdhNzFiXkEyXkFqcGdeQXVyMTMxODk2OTU@._V1_.jpg,"Crime, Drama"
1749,Shame,1656,1933,-277,https://www.imdb.com/title/tt1723811/,https://m.media-amazon.com/images/M/MV5BOGU4Mjc0ZWMtNGQ0OS00ZWQ4LThkNDUtOTE1Y2EzYjgzMDU5XkEyXkFqcGdeQXVyODE5NzE3OTE@._V1_.jpg,Drama
1750,Carnage,1781,1875,-94,https://www.imdb.com/title/tt1692486/,https://m.media-amazon.com/images/M/MV5BMTc4MjAyMDUwNl5BMl5BanBnXkFtZTcwOTQwMDMwNw@@._V1_.jpg,"Comedy, Drama"
1751,The Age of Adaline,1848,1470,378,https://www.imdb.com/title/tt1655441/,https://m.media-amazon.com/images/M/MV5BMTAzMTQzMTA2MjheQTJeQWpwZ15BbWU4MDk2MTg2MzUx._V1_.jpg,"Drama, Fantasy, Romance"
1752,"Love, Rosie",1991,1541,450,https://www.imdb.com/title/tt1638002/,https://m.media-amazon.com/images/M/MV5BMTk0Mzg1MTU1MF5BMl5BanBnXkFtZTgwMjU3ODI2MzE@._V1_.jpg,"Comedy, Romance"
1755,War Horse,1812,1118,694,https://www.imdb.com/title/tt1568911/,https://m.media-amazon.com/images/M/MV5BMjExNzkxOTYyNl5BMl5BanBnXkFtZTcwODA0MjU4Ng@@._V1_.jpg,"Action, Adventure, Drama"
1756,The Master,1808,1987,-179,https://www.imdb.com/title/tt1560747/,https://m.media-amazon.com/images/M/MV5BMTQ2NjQ5MzMwMF5BMl5BanBnXkFtZTcwMjczNTAzOA@@._V1_.jpg,"Drama, History"
1758,Melancholia,1906,1808,98,https://www.imdb.com/title/tt1527186/,https://m.media-amazon.com/images/M/MV5BMTk4NjM0MjI3MV5BMl5BanBnXkFtZTcwNjcxMDYzNg@@._V1_.jpg,"Drama, Sci-Fi"
1761,The Hunger Games,1944,651,1293,https://www.imdb.com/title/tt1392170/,https://m.media-amazon.com/images/M/MV5BZWI1OWM3ZmEtNjQ2OS00NzI2LTgwNWMtZDAyMGI1OTM2MzJmXkEyXkFqcGdeQXVyNjc5NjEzNA@@._V1_.jpg,"Action, Adventure, Sci-Fi"
1762,The Great Gatsby,1809,1266,543,https://www.imdb.com/title/tt1343092/,https://m.media-amazon.com/images/M/MV5BMTkxNTk1ODcxNl5BMl5BanBnXkFtZTcwMDI1OTMzOQ@@._V1_.jpg,"Drama, Romance"
1763,Lee Daniels' The Butler,1963,1295,668,https://www.imdb.com/title/tt1327773/,https://m.media-amazon.com/images/M/MV5BMjM2NDY3MjkyMF5BMl5BanBnXkFtZTcwMDM5Nzg5OQ@@._V1_.jpg,"Biography, Drama"
1765,Kung Fu Panda 2,1626,1790,-164,https://www.imdb.com/title/tt1302011/,https://m.media-amazon.com/images/M/MV5BYzQ0ZWIxZjAtYWI3Yy00MGM0LWFjOGYtNzcyYThiOTA3ODI1XkEyXkFqcGdeQXVyODE5NzE3OTE@._V1_.jpg,"Animation, Action, Adventure"
1769,21 Jump Street,1775,1723,52,https://www.imdb.com/title/tt1232829/,https://m.media-amazon.com/images/M/MV5BNTZjNzRjMTMtZDMzNy00Y2ZjLTg0OTAtZjVhNzYyZmJjOTljXkEyXkFqcGdeQXVyODE5NzE3OTE@._V1_.jpg,"Action, Comedy, Crime"
1771,Rango,1642,1972,-330,https://www.imdb.com/title/tt1192628/,https://m.media-amazon.com/images/M/MV5BMTc4NjEyODE1OV5BMl5BanBnXkFtZTcwMjYzNTkxNA@@._V1_.jpg,"Animation, Action, Adventure"
1775,10 Cloverfield Lane,1645,1929,-284,https://www.imdb.com/title/tt1179933/,https://m.media-amazon.com/images/M/MV5BMjEzMjczOTIxMV5BMl5BanBnXkFtZTgwOTUwMjI3NzE@._V1_.jpg,"Drama, Horror, Mystery"
1777,The Ghost Writer,1718,1879,-161,https://www.imdb.com/title/tt1139328/,https://m.media-amazon.com/images/M/MV5BMTI3NzMwMzkyNV5BMl5BanBnXkFtZTcwODk4NjQxMw@@._V1_.jpg,"Crime, Drama, Mystery"
1778,Paddington,1798,1512,286,https://www.imdb.com/title/tt1109624/,https://m.media-amazon.com/images/M/MV5BMTAxOTMwOTkwNDZeQTJeQWpwZ15BbWU4MDEyMTI1NjMx._V1_.jpg,"Adventure, Comedy, Family"
1780,Defiance,1871,1544,327,https://www.imdb.com/title/tt1034303/,https://m.media-amazon.com/images/M/MV5BZjEyYjk4ZDQtZDhjMi00NGFkLWExM2UtZjgyMDMxODgwNjgyXkEyXkFqcGdeQXVyNTA4NzY1MzY@._V1_.jpg,"Action, Drama, History"
1782,Megamind,1703,1526,177,https://www.imdb.com/title/tt1001526/,https://m.media-amazon.com/images/M/MV5BMTAzMzI0NTMzNDBeQTJeQWpwZ15BbWU3MDM3NTAyOTM@._V1_.jpg,"Animation, Action, Adventure"
1784,The Road,1687,1872,-185,https://www.imdb.com/title/tt0898367/,https://m.media-amazon.com/images/M/MV5BMTAwNzk4NTU3NDReQTJeQWpwZ15BbWU3MDg3OTEyODI@._V1_.jpg,"Drama, Thriller"
1786,The Darjeeling Limited,1790,1446,344,https://www.imdb.com/title/tt0838221/,https://m.media-amazon.com/images/M/MV5BMTgwMDY4ZjYtNzlkYi00YjE1LTg0MDgtZmRhYTZkNTk4MDdhXkEyXkFqcGdeQXVyMTA4NDI1NTQx._V1_.jpg,"Adventure, Comedy, Drama"
1787,Shooter,1863,1824,39,https://www.imdb.com/title/tt0822854/,https://m.media-amazon.com/images/M/MV5BMGRjMzY0OGItNDc4YS00OGNlLWI3MGYtZjRkNjdiNWUyNDY4XkEyXkFqcGdeQXVyNTA4NzY1MzY@._V1_.jpg,"Action, Drama, Thriller"
1789,Silence,1839,1967,-128,https://www.imdb.com/title/tt0490215/,https://m.media-amazon.com/images/M/MV5BMjY3OTk0NjA2NV5BMl5BanBnXkFtZTgwNTg3Mjc2MDI@._V1_.jpg,"Drama, History"
1790,Fracture,1740,1430,310,https://www.imdb.com/title/tt0488120/,https://m.media-amazon.com/images/M/MV5BMzIzNjQyMzkwM15BMl5BanBnXkFtZTcwOTg5ODQ0MQ@@._V1_.jpg,"Crime, Drama, Thriller"
1791,The Croods,1883,1400,483,https://www.imdb.com/title/tt0481499/,https://m.media-amazon.com/images/M/MV5BMTcyOTc2OTA1Ml5BMl5BanBnXkFtZTcwOTI1MjkzOQ@@._V1_.jpg,"Animation, Adventure, Comedy"
1793,I Am Legend,1850,1844,6,https://www.imdb.com/title/tt0480249/,https://m.media-amazon.com/images/M/MV5BYTE1ZTBlYzgtNmMyNS00ZTQ2LWE4NjEtZjUxNDJkNTg2MzlhXkEyXkFqcGdeQXVyNjU0OTQ0OTY@._V1_.jpg,"Action, Drama, Horror"
1797,Michael Clayton,1693,1900,-207,https://www.imdb.com/title/tt0465538/,https://m.media-amazon.com/images/M/MV5BMTc0NTU5MjI2MV5BMl5BanBnXkFtZTcwMTg5NTQzMw@@._V1_.jpg,"Crime, Drama, Mystery"
1800,The Equalizer,1707,1715,-8,https://www.imdb.com/title/tt0455944/,https://m.media-amazon.com/images/M/MV5BMTQ2MzE2NTk0NF5BMl5BanBnXkFtZTgwOTM3NTk1MjE@._V1_.jpg,"Action, Crime, Thriller"
1801,Sunshine,1618,1828,-210,https://www.imdb.com/title/tt0448134/,https://m.media-amazon.com/images/M/MV5BMDliNGY4ZGQtMjU5MS00ODhjLWExMDEtNzI1NmIwZDkzZWQwXkEyXkFqcGdeQXVyNTAyODkwOQ@@._V1_.jpg,"Sci-Fi, Thriller"
1803,The Descent,1780,1892,-112,https://www.imdb.com/title/tt0435625/,https://m.media-amazon.com/images/M/MV5BMjA5NzQ1NTgwNV5BMl5BanBnXkFtZTcwNjUxMzUzMw@@._V1_.jpg,"Adventure, Horror, Thriller"
1806,The Fountain,1726,1734,-8,https://www.imdb.com/title/tt0414993/,https://m.media-amazon.com/images/M/MV5BMTU5OTczMTcxMV5BMl5BanBnXkFtZTcwNDg3MTEzMw@@._V1_.jpg,"Drama, Mystery, Romance"
1814,Closer,1662,1730,-68,https://www.imdb.com/title/tt0376541/,https://m.media-amazon.com/images/M/MV5BN2I0Y2JmZjQtNjEyOC00ODhkLWE5YWUtOWFkOGQwMGYyODRiXkEyXkFqcGdeQXVyNDk3NzU2MTQ@._V1_.jpg,"Drama, Romance"
1815,Team America: World Police,1805,1992,-187,https://www.imdb.com/title/tt0372588/,https://m.media-amazon.com/images/M/MV5BMTM2Nzc4NjYxMV5BMl5BanBnXkFtZTcwNTM1MTcyMQ@@._V1_.jpg,"Action, Comedy"
1820,King Kong,500,1292,-792,https://www.imdb.com/title/tt0360717/,https://m.media-amazon.com/images/M/MV5BMjYxYmRlZWYtMzAwNC00MDA1LWJjNTItOTBjMzlhNGMzYzk3XkEyXkFqcGdeQXVyMTQxNzMzNDI@._V1_.jpg,"Action, Adventure, Romance"
1821,Anchorman: The Legend of Ron Burgundy,1677,1985,-308,https://www.imdb.com/title/tt0357413/,https://m.media-amazon.com/images/M/MV5BMTQ2MzYwMzk5Ml5BMl5BanBnXkFtZTcwOTI4NzUyMw@@._V1_.jpg,Comedy
1823,The Passion of the Christ,1932,1624,308,https://www.imdb.com/title/tt0335345/,https://m.media-amazon.com/images/M/MV5BYjE2MDNhMzItNmMzNi00NzY1LWIwNTktNmE5ZWE4OTcyNjJhXkEyXkFqcGdeQXVyMjUzOTY1NTc@._V1_.jpg,Drama
1825,Kingdom of Heaven,1650,1947,-297,https://www.imdb.com/title/tt0320661/,https://m.media-amazon.com/images/M/MV5BMTI2ODhkMjMtYWU2Yy00MjI1LThlNDctZTJmNDE2MDE4ZDYzXkEyXkFqcGdeQXVyMjUzOTY1NTc@._V1_.jpg,"Action, Adventure, Drama"
1827,The Dreamers,1897,1469,428,https://www.imdb.com/title/tt0309987/,https://m.media-amazon.com/images/M/MV5BN2JlNDM0YjQtNjg3NC00MWY0LTk0MmMtMTVkMmU0MDQ4MGMzXkEyXkFqcGdeQXVyMjUzOTY1NTc@._V1_.jpg,"Drama, Romance"
1828,Chicago,1981,1332,649,https://www.imdb.com/title/tt0299658/,https://m.media-amazon.com/images/M/MV5BN2E3NDU1ZTktNzZjNy00MWU3LWI4YmMtMjdjNTIzMDU0MDdiXkEyXkFqcGdeQXVyMTMxODk2OTU@._V1_.jpg,"Comedy, Crime, Musical"
1829,Shrek 2,1807,1575,232,https://www.imdb.com/title/tt0298148/,https://m.media-amazon.com/images/M/MV5BMDJhMGRjN2QtNDUxYy00NGM3LThjNGQtMmZiZTRhNjM4YzUxL2ltYWdlL2ltYWdlXkEyXkFqcGdeQXVyMTQxNzMzNDI@._V1_.jpg,"Animation, Adventure, Comedy"
1830,The Phantom of the Opera,1989,933,1056,https://www.imdb.com/title/tt0293508/,https://m.media-amazon.com/images/M/MV5BNDczNzg4OTM3MV5BMl5BanBnXkFtZTcwOTQzMTEzMw@@._V1_.jpg,"Drama, Musical, Romance"
1831,Red Dragon,1731,1561,170,https://www.imdb.com/title/tt0289765/,https://m.media-amazon.com/images/M/MV5BOTAwZDI1OTctN2Q5YS00OGNiLWIyMmUtYWM4ZGFjYWYyYzJjXkEyXkFqcGdeQXVyMTUzMDUzNTI3._V1_.jpg,"Crime, Drama, Thriller"
1833,Insomnia,1724,1960,-236,https://www.imdb.com/title/tt0278504/,https://m.media-amazon.com/images/M/MV5BYzlkZTEyYjUtMTY5NS00ZjU0LTk5OTYtM2M0ZDg1NmNjMzhkXkEyXkFqcGdeQXVyMTQxNzMzNDI@._V1_.jpg,"Drama, Mystery, Thriller"
1834,We Were Soldiers,1826,1858,-32,https://www.imdb.com/title/tt0277434/,https://m.media-amazon.com/images/M/MV5BZTk3NTc4MTktNjFmZC00ZjdjLWE0ZjgtNTM4NzdmMDBjOTcxXkEyXkFqcGdeQXVyNDkzNTM2ODg@._V1_.jpg,"Action, Drama, History"
1835,Lilo & Stitch,1951,1234,717,https://www.imdb.com/title/tt0275847/,https://m.media-amazon.com/images/M/MV5BYTY5MGE4MjEtNTMzYy00ODAxLWFiNDQtNzhlOGJiZWIzNDhkXkEyXkFqcGdeQXVyNTM5NzI0NDY@._V1_.jpg,"Animation, Adventure, Comedy"
1837,Chocolat,1885,1158,727,https://www.imdb.com/title/tt0241303/,https://m.media-amazon.com/images/M/MV5BYWYwMjMxZWQtMzQ3OS00YWNhLThkNDItYTk4NDdhZDE4ZTEzXkEyXkFqcGdeQXVyODU5MDg5OTY@._V1_.jpg,"Drama, Romance"
1839,The Matrix Reloaded,1762,1920,-158,https://www.imdb.com/title/tt0234215/,https://m.media-amazon.com/images/M/MV5BODE0MzZhZTgtYzkwYi00YmI5LThlZWYtOWRmNWE5ODk0NzMxXkEyXkFqcGdeQXVyNjU0OTQ0OTY@._V1_.jpg,"Action, Sci-Fi"
1840,Pay It Forward,1927,1197,730,https://www.imdb.com/title/tt0223897/,https://m.media-amazon.com/images/M/MV5BNjI3ODI5NDEwMl5BMl5BanBnXkFtZTYwNDYyMjU3._V1_.jpg,Drama
1842,A.I. Artificial Intelligence,1890,1688,202,https://www.imdb.com/title/tt0212720/,https://m.media-amazon.com/images/M/MV5BNWU2NzEyMDYtM2MyOS00OGM3LWFkNzAtMzRiNzE2ZjU5ZTljXkEyXkFqcGdeQXVyNjU0OTQ0OTY@._V1_.jpg,"Adventure, Drama, Sci-Fi"
1843,Men of Honor,1756,1213,543,https://www.imdb.com/title/tt0203019/,https://m.media-amazon.com/images/M/MV5BMjkxZGVmNzQtYjE0OC00MzVlLTkxODYtNzdkMjE3MmZjYjUxXkEyXkFqcGdeQXVyMjUzOTY1NTc@._V1_.jpg,"Biography, Drama"
1844,The Bank Job,1705,1925,-220,https://www.imdb.com/title/tt0200465/,https://m.media-amazon.com/images/M/MV5BMmE2NzEyOWItYjI1ZC00YWZhLWI2MjEtZmU1NjIyNjliOTkyXkEyXkFqcGdeQXVyMTYzMDM0NTU@._V1_.jpg,"Crime, Drama, Thriller"
1845,The Patriot,1870,1692,178,https://www.imdb.com/title/tt0187393/,https://m.media-amazon.com/images/M/MV5BNjUxYzliZjUtZTcyZS00NjQ2LTkxZWMtMzg5OWUxZGZkODFjXkEyXkFqcGdeQXVyMTUzMDUzNTI3._V1_.jpg,"Action, Drama, History"
1849,Cold Mountain,1882,1566,316,https://www.imdb.com/title/tt0159365/,https://m.media-amazon.com/images/M/MV5BMTY3NTc5NzcyOF5BMl5BanBnXkFtZTcwMDM0NjQyMQ@@._V1_.jpg,"Adventure, Drama, Romance"
1850,The Virgin Suicides,1828,1676,152,https://www.imdb.com/title/tt0159097/,https://m.media-amazon.com/images/M/MV5BNTMyMjI3MmItODIzNS00OWNiLWE5NTQtYmNhNGNlOTYyYWExXkEyXkFqcGdeQXVyMTA0MjU0Ng@@._V1_.jpg,"Drama, Romance"
1854,Treasure Planet,1969,1528,441,https://www.imdb.com/title/tt0133240/,https://m.media-amazon.com/images/M/MV5BNGI0N2EzZDktNDY3OS00NWFmLTgxZjEtMTc1OTNlMzQxNDZkXkEyXkFqcGdeQXVyNTAyODkwOQ@@._V1_.jpg,"Animation, Adventure, Family"
1856,Cube,1667,1859,-192,https://www.imdb.com/title/tt0123755/,https://m.media-amazon.com/images/M/MV5BZTIyZGM3NDItMTNmNS00Yzc4LTg2MzItOWY4MTE1NDlmZDIyXkEyXkFqcGdeQXVyMTAwMzUyOTc@._V1_.jpg,"Horror, Mystery, Sci-Fi"
1859,A Bug's Life,1806,1807,-1,https://www.imdb.com/title/tt0120623/,https://m.media-amazon.com/images/M/MV5BNThmZGY4NzgtMTM4OC00NzNkLWEwNmEtMjdhMGY5YTc1NDE4XkEyXkFqcGdeQXVyMTQxNzMzNDI@._V1_.jpg,"Animation, Adventure, Comedy"
1860,Starship Troopers,1564,1991,-427,https://www.imdb.com/title/tt0120201/,https://m.media-amazon.com/images/M/MV5BNWExNzg3MmMtYjc3MS00MzFlLWJiOWQtNWYxZTgxNjhlZTQ2XkEyXkFqcGdeQXVyNzkwMjQ5NzM@._V1_.jpg,"Action, Adventure, Sci-Fi"
1862,Meet Joe Black,1842,1699,143,https://www.imdb.com/title/tt0119643/,https://m.media-amazon.com/images/M/MV5BNmVlN2NiZWItY2JlMy00NzRmLTg0Y2ItZmM0ZjVjZjMyM2Q4XkEyXkFqcGdeQXVyMTUzMDUzNTI3._V1_.jpg,"Drama, Fantasy, Romance"
1865,Face/Off,1613,1820,-207,https://www.imdb.com/title/tt0119094/,https://m.media-amazon.com/images/M/MV5BYzFjNzIxMmEtMzY5NS00YTgzLTkwYWEtN2FjMmY0NmNkZWY3XkEyXkFqcGdeQXVyMTQxNzMzNDI@._V1_.jpg,"Action, Crime, Sci-Fi"
1866,Chasing Amy,1606,1984,-378,https://www.imdb.com/title/tt0118842/,https://m.media-amazon.com/images/M/MV5BZDM3MTg2MGUtZDM0MC00NzMwLWE5NjItOWFjNjA2M2I4YzgxXkEyXkFqcGdeQXVyMTQxNzMzNDI@._V1_.jpg,"Comedy, Drama, Romance"
1867,Anastasia,2000,810,1190,https://www.imdb.com/title/tt0118617/,https://m.media-amazon.com/images/M/MV5BNGJiNWFlYTMtZTBiZi00ZTVmLWJmZmMtNzEzYzZjNzYzZmRmXkEyXkFqcGdeQXVyNTA4NzY1MzY@._V1_.jpg,"Animation, Adventure, Drama"
1869,Mission: Impossible,1814,1968,-154,https://www.imdb.com/title/tt0117060/,https://m.media-amazon.com/images/M/MV5BOTFhMWY3ZTctNTJlOC00Y2UwLThmOGUtMWU4NDI1Yzg4ODRkXkEyXkFqcGdeQXVyMTUzMDUzNTI3._V1_.jpg,"Action, Adventure, Thriller"
1871,From Dusk Till Dawn,1614,1821,-207,https://www.imdb.com/title/tt0116367/,https://m.media-amazon.com/images/M/MV5BZjk3YmZhMDAtOWUzMS00YjE5LTkxNzAtY2I1NGZjMDA2ZTk0XkEyXkFqcGdeQXVyMTQxNzMzNDI@._V1_.jpg,"Action, Crime, Horror"
1874,GoldenEye,1787,1983,-196,https://www.imdb.com/title/tt0113189/,https://m.media-amazon.com/images/M/MV5BOWI0MTJlMjEtYTI0ZS00NWZiLWE1ZmItYzBlZTE5YTk3NTJiXkEyXkFqcGdeQXVyMTEwNDU1MzEy._V1_.jpg,"Action, Adventure, Thriller"
1875,Desperado,1820,1864,-44,https://www.imdb.com/title/tt0112851/,https://m.media-amazon.com/images/M/MV5BYjA0NDMyYTgtMDgxOC00NGE0LWJkOTQtNDRjMjEzZmU0ZTQ3XkEyXkFqcGdeQXVyMTQxNzMzNDI@._V1_.jpg,"Action, Crime, Drama"
1876,True Lies,1686,1809,-123,https://www.imdb.com/title/tt0111503/,https://m.media-amazon.com/images/M/MV5BYzg5YmUyNGMtMThiNS00MjA2LTgwZDctNDlhM2RkZDNmZmRkXkEyXkFqcGdeQXVyNDk3NzU2MTQ@._V1_.jpg,"Action, Comedy, Thriller"
1877,Speed,1704,1694,10,https://www.imdb.com/title/tt0111257/,https://m.media-amazon.com/images/M/MV5BYjc0MjYyN2EtZGRhMy00NzJiLWI2Y2QtYzhiYTU3NzAxNzg4XkEyXkFqcGdeQXVyMTQxNzMzNDI@._V1_.jpg,"Action, Adventure, Thriller"
1891,Die Hard 2,1815,1935,-120,https://www.imdb.com/title/tt0099423/,https://m.media-amazon.com/images/M/MV5BMzMzYzk3ZTEtZDg0My00MTY5LWE3ZmQtYzNhYjhjN2RhZGRjL2ltYWdlXkEyXkFqcGdeQXVyNTAyODkwOQ@@._V1_.jpg,"Action, Thriller"
1894,Lethal Weapon 2,1683,1848,-165,https://www.imdb.com/title/tt0097733/,https://m.media-amazon.com/images/M/MV5BZWE1OWYwZTAtMGUwMC00MGE3LWE1ODAtMTI0NGQ1NzU5YmYzXkEyXkFqcGc@._V1_.jpg,"Action, Crime, Thriller"
1916,Escape from New York,1838,1949,-111,https://www.imdb.com/title/tt0082340/,https://m.media-amazon.com/images/M/MV5BMTUzMTY0Nzg0MV5BMl5BanBnXkFtZTgwMDU3MzQxMDE@._V1_.jpg,"Action, Adventure, Sci-Fi"
1921,Grease,1975,1012,963,https://www.imdb.com/title/tt0077631/,https://m.media-amazon.com/images/M/MV5BZmUyMDEyOTgtZmUwOS00NTdkLThlNzctNTM1ODQ4M2VhMjdhXkEyXkFqcGdeQXVyNzkwMjQ5NzM@._V1_.jpg,"Comedy, Musical, Romance"
1925,Mean Streets,1646,1853,-207,https://www.imdb.com/title/tt0070379/,https://m.media-amazon.com/images/M/MV5BMWNmNGY3ZGMtYWQ3OC00Zjg4LWFiN2EtZjM2MDI1YzRiNjg3XkEyXkFqcGdeQXVyMTQxNzMzNDI@._V1_.jpg,"Crime, Drama, Thriller"
1935,Dr. No,1640,1899,-259,https://www.imdb.com/title/tt0055928/,https://m.media-amazon.com/images/M/MV5BNWNjNGU5ZjUtMzc0MC00MWY5LTkxMGUtMjcxZmM2MDYzYzQ4XkEyXkFqcGdeQXVyMjUzOTY1NTc@._V1_.jpg,"Action, Adventure, Thriller"
1936,Sleeping Beauty,1904,1121,783,https://www.imdb.com/title/tt0053285/,https://m.media-amazon.com/images/M/MV5BOTJmZjA3MjMtMWNmZS00YTliLWFhMWUtZDU2NGJhNTlmY2ZkL2ltYWdlL2ltYWdlXkEyXkFqcGdeQXVyMTQxNzMzNDI@._V1_.jpg,"Animation, Adventure, Family"
1940,Dumbo,1759,1597,162,https://www.imdb.com/title/tt0033563/,https://m.media-amazon.com/images/M/MV5BMmU1NjQ3YjktZGMxYS00N2IwLTllZWQtOGNjYWE4MzgxNzk2XkEyXkFqcGdeQXVyODU2MDg1NzU@._V1_.jpg,"Animation, Adventure, Drama"
1943,Midsommar,1953,1954,-1,https://www.imdb.com/title/tt8772262/,https://m.media-amazon.com/images/M/MV5BMzQxNzQzOTQwM15BMl5BanBnXkFtZTgwMDQ2NTcwODM@._V1_.jpg,"Drama, Horror, Mystery"
1946,The Devil All the Time,1967,1898,69,https://www.imdb.com/title/tt7395114/,https://m.media-amazon.com/images/M/MV5BZmE1NmVmN2EtMjZmZC00YzAyLWE4MWEtYjY5YmExMjUxODU1XkEyXkFqcGdeQXVyMTkxNjUyNQ@@._V1_.jpg,"Crime, Drama, Thriller"
1949,Bad Times at the El Royale,1930,1883,47,https://www.imdb.com/title/tt6628394/,https://m.media-amazon.com/images/M/MV5BOTk1Nzk1MDc1MF5BMl5BanBnXkFtZTgwNjU2NDExNjM@._V1_.jpg,"Crime, Drama, Mystery"
1952,Creed II,1948,1733,215,https://www.imdb.com/title/tt6343314/,https://m.media-amazon.com/images/M/MV5BYmEyNWZhM2YtZDAyNi00ZjYzLWI2ZWMtOWM4ZmI1MDE0OWNmXkEyXkFqcGdeQXVyMjMwNDgzNjc@._V1_.jpg,"Action, Drama, Sport"
1955,Sicario: Day of the Soldado,1960,1955,5,https://www.imdb.com/title/tt5052474/,https://m.media-amazon.com/images/M/MV5BMTEzNjM2NTYxMjReQTJeQWpwZ15BbWU4MDU2NzAxNTUz._V1_.jpg,"Action, Crime, Drama"
1960,Don't Breathe,1912,1956,-44,https://www.imdb.com/title/tt4160708/,https://m.media-amazon.com/images/M/MV5BZGI5ZTU2M2YtZWY4MC00ZDFhLTliYTItZTk1NjdlN2NkMzg2XkEyXkFqcGdeQXVyMjY5ODI4NDk@._V1_.jpg,"Crime, Horror, Thriller"
1967,Allied,1880,1915,-35,https://www.imdb.com/title/tt3640424/,https://m.media-amazon.com/images/M/MV5BZWEyMzg4ZWUtYmZhMC00Yjk2LWEyYjktODVmN2M3YTA2ZmNjXkEyXkFqcGdeQXVyNjQ2Mjg3OTI@._V1_.jpg,"Action, Drama, Romance"
1970,Sing,1947,1619,328,https://www.imdb.com/title/tt3470600/,https://m.media-amazon.com/images/M/MV5BMTYzODYzODU2Ml5BMl5BanBnXkFtZTgwNTc1MTA2NzE@._V1_.jpg,"Animation, Comedy, Family"
1976,Furious 7,1961,1108,853,https://www.imdb.com/title/tt2820852/,https://m.media-amazon.com/images/M/MV5BMTQxOTA2NDUzOV5BMl5BanBnXkFtZTgwNzY2MTMxMzE@._V1_.jpg,"Action, Crime, Thriller"
1978,Beauty and the Beast,635,40,595,https://www.imdb.com/title/tt2771200/,https://m.media-amazon.com/images/M/MV5BMTUwNjUxMTM4NV5BMl5BanBnXkFtZTgwODExMDQzMTI@._V1_.jpg,"Adventure, Family, Fantasy"
1981,Everest,1970,1825,145,https://www.imdb.com/title/tt2719848/,https://m.media-amazon.com/images/M/MV5BMTNmMzM0ZTktZWY3Yy00ODViLTllZDgtODcwM2QyM2E2YTU2L2ltYWdlXkEyXkFqcGdeQXVyNjU0OTQ0OTY@._V1_.jpg,"Action, Adventure, Biography"
1982,Locke,1902,1913,-11,https://www.imdb.com/title/tt2692904/,https://m.media-amazon.com/images/M/MV5BMTQ1MjE5MzU2M15BMl5BanBnXkFtZTgwNzE4OTMzMTE@._V1_.jpg,Drama
1983,Star Trek Beyond,1984,1535,449,https://www.imdb.com/title/tt2660888/,https://m.media-amazon.com/images/M/MV5BNDc2YThlMTgtN2M3Yi00YzkxLWE4MDQtMWJmYmZiNTNjNjJlXkEyXkFqcGdeQXVyMjUzOTY1NTc@._V1_.jpg,"Action, Adventure, Sci-Fi"
1986,The Intern,1923,1613,310,https://www.imdb.com/title/tt2361509/,https://m.media-amazon.com/images/M/MV5BMTUyNjE5NjI5OF5BMl5BanBnXkFtZTgwNzYzMzU3NjE@._V1_.jpg,"Comedy, Drama"
1988,Wild,1937,1548,389,https://www.imdb.com/title/tt2305051/,https://m.media-amazon.com/images/M/MV5BMGMzZmYzYmUtNTJiYi00MjZjLTkyZmMtZGJhYWRlMDBkMDIyXkEyXkFqcGdeQXVyNjA5MDIyMzU@._V1_.jpg,"Adventure, Biography, Drama"
1990,Kung Fu Panda 3,1939,1680,259,https://www.imdb.com/title/tt2267968/,https://m.media-amazon.com/images/M/MV5BMTUyNzgxNjg2M15BMl5BanBnXkFtZTgwMTY1NDI1NjE@._V1_.jpg,"Animation, Action, Adventure"
1997,Side Effects,1919,1940,-21,https://www.imdb.com/title/tt2053463/,https://m.media-amazon.com/images/M/MV5BMTc2MzY0NDAwOF5BMl5BanBnXkFtZTcwMTE1Mzc4OA@@._V1_.jpg,"Crime, Drama, Mystery"
1998,War Dogs,1894,1938,-44,https://www.imdb.com/title/tt2005151/,https://m.media-amazon.com/images/M/MV5BMjEyNzQ0NzM4MV5BMl5BanBnXkFtZTgwMDI0ODM2OTE@._V1_.jpg,"Biography, Comedy, Crime"
2000,Pitch Perfect,1983,1383,600,https://www.imdb.com/title/tt1981677/,https://m.media-amazon.com/images/M/MV5BMTcyMTMzNzE5N15BMl5BanBnXkFtZTcwNzg5NjM5Nw@@._V1_.jpg,"Comedy, Music, Romance"
