ID,Name,Male,Female,Delta,Link,poster,genre
2,The Shawshank Redemption,1,3,-2,https://www.imdb.com/title/tt0111161/,https://raw.githubusercontent.com/eledah/imdb-delta/main/thumbnails/tt0111161.jpg,Drama
3,The Godfather,3,7,-4,https://www.imdb.com/title/tt0068646/,https://raw.githubusercontent.com/eledah/imdb-delta/main/thumbnails/tt0068646.jpg,"Crime, Drama"
4,The Dark Knight,5,17,-12,https://www.imdb.com/title/tt0468569/,https://raw.githubusercontent.com/eledah/imdb-delta/main/thumbnails/tt0468569.jpg,"Action, Crime, Drama"
5,The Godfather: Part II,4,14,-10,https://www.imdb.com/title/tt0071562/,https://raw.githubusercontent.com/eledah/imdb-delta/main/thumbnails/tt0071562.jpg,"Crime, Drama"
6,12 Angry Men,8,10,-2,https://www.imdb.com/title/tt0050083/,https://raw.githubusercontent.com/eledah/imdb-delta/main/thumbnails/tt0050083.jpg,"Crime, Drama"
7,The Lord of the Rings: The Return of the King,7,8,-1,https://www.imdb.com/title/tt0167260/,https://raw.githubusercontent.com/eledah/imdb-delta/main/thumbnails/tt0167260.jpg,"Action, Adventure, Drama"
8,Pulp Fiction,6,38,-32,https://www.imdb.com/title/tt0110912/,https://raw.githubusercontent.com/eledah/imdb-delta/main/thumbnails/tt0110912.jpg,"Crime, Drama"
9,Schindler's List,9,5,4,https://www.imdb.com/title/tt0108052/,https://raw.githubusercontent.com/eledah/imdb-delta/main/thumbnails/tt0108052.jpg,"Biography, Drama, History"
10,The Mountain II,13,6,7,https://www.imdb.com/title/tt5813916/,https://raw.githubusercontent.com/eledah/imdb-delta/main/thumbnails/tt5813916.jpg,"Action, Drama, War"
11,Inception,14,24,-10,https://www.imdb.com/title/tt1375666/,https://raw.githubusercontent.com/eledah/imdb-delta/main/thumbnails/tt1375666.jpg,"Action, Adventure, Sci-Fi"
12,Fight Club,11,19,-8,https://www.imdb.com/title/tt0137523/,https://raw.githubusercontent.com/eledah/imdb-delta/main/thumbnails/tt0137523.jpg,Drama
13,The Lord of the Rings: The Fellowship of the Ring,12,12,0,https://www.imdb.com/title/tt0120737/,https://raw.githubusercontent.com/eledah/imdb-delta/main/thumbnails/tt0120737.jpg,"Action, Adventure, Drama"
14,Forrest Gump,15,18,-3,https://www.imdb.com/title/tt0109830/,https://raw.githubusercontent.com/eledah/imdb-delta/main/thumbnails/tt0109830.jpg,"Drama, Romance"
15,"The Good, the Bad and the Ugly",10,76,-66,https://www.imdb.com/title/tt0060196/,https://raw.githubusercontent.com/eledah/imdb-delta/main/thumbnails/tt0060196.jpg,"Adventure, Drama, Western"
16,The Lord of the Rings: The Two Towers,17,20,-3,https://www.imdb.com/title/tt0167261/,https://raw.githubusercontent.com/eledah/imdb-delta/main/thumbnails/tt0167261.jpg,"Action, Adventure, Drama"
17,The Matrix,18,113,-95,https://www.imdb.com/title/tt0133093/,https://raw.githubusercontent.com/eledah/imdb-delta/main/thumbnails/tt0133093.jpg,"Action, Sci-Fi"
18,Goodfellas,21,102,-81,https://www.imdb.com/title/tt0099685/,https://raw.githubusercontent.com/eledah/imdb-delta/main/thumbnails/tt0099685.jpg,"Biography, Crime, Drama"
19,Star Wars: Episode V - The Empire Strikes Back,16,57,-41,https://www.imdb.com/title/tt0080684/,https://raw.githubusercontent.com/eledah/imdb-delta/main/thumbnails/tt0080684.jpg,"Action, Adventure, Fantasy"
20,One Flew Over the Cuckoo's Nest,20,28,-8,https://www.imdb.com/title/tt0073486/,https://raw.githubusercontent.com/eledah/imdb-delta/main/thumbnails/tt0073486.jpg,Drama
21,Parasite,46,37,9,https://www.imdb.com/title/tt6751668/,https://raw.githubusercontent.com/eledah/imdb-delta/main/thumbnails/tt6751668.jpg,"Drama, Thriller"
23,Interstellar,25,79,-54,https://www.imdb.com/title/tt0816692/,https://raw.githubusercontent.com/eledah/imdb-delta/main/thumbnails/tt0816692.jpg,"Adventure, Drama, Sci-Fi"
24,City of God,23,71,-48,https://www.imdb.com/title/tt0317248/,https://raw.githubusercontent.com/eledah/imdb-delta/main/thumbnails/tt0317248.jpg,"Crime, Drama"
25,Spirited Away,43,13,30,https://www.imdb.com/title/tt0245429/,https://raw.githubusercontent.com/eledah/imdb-delta/main/thumbnails/tt0245429.jpg,"Animation, Adventure, Family"
26,Saving Private Ryan,28,282,-254,https://www.imdb.com/title/tt0120815/,https://raw.githubusercontent.com/eledah/imdb-delta/main/thumbnails/tt0120815.jpg,"Drama, War"
27,The Green Mile,42,21,21,https://www.imdb.com/title/tt0120689/,https://raw.githubusercontent.com/eledah/imdb-delta/main/thumbnails/tt0120689.jpg,"Crime, Drama, Fantasy"
28,Life Is Beautiful,36,9,27,https://www.imdb.com/title/tt0118799/,https://raw.githubusercontent.com/eledah/imdb-delta/main/thumbnails/tt0118799.jpg,"Comedy, Drama, Romance"
29,Se7en,22,44,-22,https://www.imdb.com/title/tt0114369/,https://raw.githubusercontent.com/eledah/imdb-delta/main/thumbnails/tt0114369.jpg,"Crime, Drama, Mystery"
30,The Silence of the Lambs,30,33,-3,https://www.imdb.com/title/tt0102926/,https://raw.githubusercontent.com/eledah/imdb-delta/main/thumbnails/tt0102926.jpg,"Crime, Drama, Thriller"
31,Star Wars: Episode IV - A New Hope,26,58,-32,https://www.imdb.com/title/tt0076759/,https://raw.githubusercontent.com/eledah/imdb-delta/main/thumbnails/tt0076759.jpg,"Action, Adventure, Fantasy"
33,Seven Samurai,19,109,-90,https://www.imdb.com/title/tt0047478/,https://raw.githubusercontent.com/eledah/imdb-delta/main/thumbnails/tt0047478.jpg,"Action, Drama"
34,It's a Wonderful Life,24,32,-8,https://www.imdb.com/title/tt0038650/,https://raw.githubusercontent.com/eledah/imdb-delta/main/thumbnails/tt0038650.jpg,"Drama, Family, Fantasy"
37,Whiplash,52,97,-45,https://www.imdb.com/title/tt2582802/,https://raw.githubusercontent.com/eledah/imdb-delta/main/thumbnails/tt2582802.jpg,"Drama, Music"
38,The Intouchables,49,15,34,https://www.imdb.com/title/tt1675434/,https://raw.githubusercontent.com/eledah/imdb-delta/main/thumbnails/tt1675434.jpg,"Comedy, Drama"
39,The Prestige,40,84,-44,https://www.imdb.com/title/tt0482571/,https://raw.githubusercontent.com/eledah/imdb-delta/main/thumbnails/tt0482571.jpg,"Drama, Mystery, Sci-Fi"
40,The Departed,47,105,-58,https://www.imdb.com/title/tt0407887/,https://raw.githubusercontent.com/eledah/imdb-delta/main/thumbnails/tt0407887.jpg,"Crime, Drama, Thriller"
41,The Pianist,50,23,27,https://www.imdb.com/title/tt0253474/,https://raw.githubusercontent.com/eledah/imdb-delta/main/thumbnails/tt0253474.jpg,"Biography, Drama, Music"
42,Gladiator,33,139,-106,https://www.imdb.com/title/tt0172495/,https://raw.githubusercontent.com/eledah/imdb-delta/main/thumbnails/tt0172495.jpg,"Action, Adventure, Drama"
43,American History X,53,29,24,https://www.imdb.com/title/tt0120586/,https://raw.githubusercontent.com/eledah/imdb-delta/main/thumbnails/tt0120586.jpg,"Crime, Drama"
44,The Usual Suspects,32,68,-36,https://www.imdb.com/title/tt0114814/,https://raw.githubusercontent.com/eledah/imdb-delta/main/thumbnails/tt0114814.jpg,"Crime, Drama, Mystery"
45,Léon: The Professional,34,25,9,https://www.imdb.com/title/tt0110413/,https://raw.githubusercontent.com/eledah/imdb-delta/main/thumbnails/tt0110413.jpg,"Action, Crime, Drama"
46,The Lion King,69,11,58,https://www.imdb.com/title/tt0110357/,https://raw.githubusercontent.com/eledah/imdb-delta/main/thumbnails/tt0110357.jpg,"Animation, Adventure, Drama"
47,Terminator 2: Judgment Day,31,317,-286,https://www.imdb.com/title/tt0103064/,https://raw.githubusercontent.com/eledah/imdb-delta/main/thumbnails/tt0103064.jpg,"Action, Adventure, Sci-Fi"
48,Cinema Paradiso,58,36,22,https://www.imdb.com/title/tt0095765/,https://raw.githubusercontent.com/eledah/imdb-delta/main/thumbnails/tt0095765.jpg,"Drama, Romance"
49,Grave of the Fireflies,59,26,33,https://www.imdb.com/title/tt0095327/,https://raw.githubusercontent.com/eledah/imdb-delta/main/thumbnails/tt0095327.jpg,"Animation, Drama, War"
50,Back to the Future,35,85,-50,https://www.imdb.com/title/tt0088763/,https://raw.githubusercontent.com/eledah/imdb-delta/main/thumbnails/tt0088763.jpg,"Adventure, Comedy, Sci-Fi"
51,Once Upon a Time in the West,48,299,-251,https://www.imdb.com/title/tt0064116/,https://raw.githubusercontent.com/eledah/imdb-delta/main/thumbnails/tt0064116.jpg,"Drama, Western"
52,Psycho,41,59,-18,https://www.imdb.com/title/tt0054215/,https://raw.githubusercontent.com/eledah/imdb-delta/main/thumbnails/tt0054215.jpg,"Horror, Mystery, Thriller"
53,Casablanca,38,95,-57,https://www.imdb.com/title/tt0034583/,https://raw.githubusercontent.com/eledah/imdb-delta/main/thumbnails/tt0034583.jpg,"Drama, Romance, War"
54,Modern Times,37,51,-14,https://www.imdb.com/title/tt0027977/,https://raw.githubusercontent.com/eledah/imdb-delta/main/thumbnails/tt0027977.jpg,"Comedy, Drama, Romance"
55,City Lights,39,43,-4,https://www.imdb.com/title/tt0021749/,https://raw.githubusercontent.com/eledah/imdb-delta/main/thumbnails/tt0021749.jpg,"Comedy, Drama, Romance"
57,Joker,73,50,23,https://www.imdb.com/title/tt7286456/,https://raw.githubusercontent.com/eledah/imdb-delta/main/thumbnails/tt7286456.jpg,"Crime, Drama, Thriller"
60,Your Name.,79,92,-13,https://www.imdb.com/title/tt5311514/,https://raw.githubusercontent.com/eledah/imdb-delta/main/thumbnails/tt5311514.jpg,"Animation, Drama, Fantasy"
61,Dangal,81,56,25,https://www.imdb.com/title/tt5074352/,https://raw.githubusercontent.com/eledah/imdb-delta/main/thumbnails/tt5074352.jpg,"Action, Biography, Drama"
62,Spider-Man: Into the Spider-Verse,112,49,63,https://www.imdb.com/title/tt4633694/,https://raw.githubusercontent.com/eledah/imdb-delta/main/thumbnails/tt4633694.jpg,"Animation, Action, Adventure"
63,Avengers: Endgame,110,41,69,https://www.imdb.com/title/tt4154796/,https://raw.githubusercontent.com/eledah/imdb-delta/main/thumbnails/tt4154796.jpg,"Action, Adventure, Drama"
64,Avengers: Infinity War,68,78,-10,https://www.imdb.com/title/tt4154756/,https://raw.githubusercontent.com/eledah/imdb-delta/main/thumbnails/tt4154756.jpg,"Action, Adventure, Sci-Fi"
66,Coco,106,31,75,https://www.imdb.com/title/tt2380307/,https://raw.githubusercontent.com/eledah/imdb-delta/main/thumbnails/tt2380307.jpg,"Animation, Adventure, Drama"
67,Django Unchained,55,90,-35,https://www.imdb.com/title/tt1853728/,https://raw.githubusercontent.com/eledah/imdb-delta/main/thumbnails/tt1853728.jpg,"Comedy, Drama, Western"
68,The Dark Knight Rises,64,91,-27,https://www.imdb.com/title/tt1345836/,https://raw.githubusercontent.com/eledah/imdb-delta/main/thumbnails/tt1345836.jpg,"Action, Drama, Thriller"
69,3 Idiots,78,104,-26,https://www.imdb.com/title/tt1187043/,https://raw.githubusercontent.com/eledah/imdb-delta/main/thumbnails/tt1187043.jpg,"Comedy, Drama"
70,Like Stars on Earth,77,119,-42,https://www.imdb.com/title/tt0986264/,https://raw.githubusercontent.com/eledah/imdb-delta/main/thumbnails/tt0986264.jpg,"Drama, Family"
71,WALL·E,70,67,3,https://www.imdb.com/title/tt0910970/,https://raw.githubusercontent.com/eledah/imdb-delta/main/thumbnails/tt0910970.jpg,"Animation, Adventure, Family"
72,The Lives of Others,67,34,33,https://www.imdb.com/title/tt0405094/,https://raw.githubusercontent.com/eledah/imdb-delta/main/thumbnails/tt0405094.jpg,"Drama, Mystery, Thriller"
73,Oldboy,74,134,-60,https://www.imdb.com/title/tt0364569/,https://raw.githubusercontent.com/eledah/imdb-delta/main/thumbnails/tt0364569.jpg,"Action, Drama, Mystery"
74,Memento,51,173,-122,https://www.imdb.com/title/tt0209144/,https://raw.githubusercontent.com/eledah/imdb-delta/main/thumbnails/tt0209144.jpg,"Mystery, Thriller"
75,Princess Mononoke,75,99,-24,https://www.imdb.com/title/tt0119698/,https://raw.githubusercontent.com/eledah/imdb-delta/main/thumbnails/tt0119698.jpg,"Animation, Action, Adventure"
76,Once Upon a Time in America,85,223,-138,https://www.imdb.com/title/tt0087843/,https://raw.githubusercontent.com/eledah/imdb-delta/main/thumbnails/tt0087843.jpg,"Crime, Drama"
77,Indiana Jones and the Raiders of the Lost Ark,56,198,-142,https://www.imdb.com/title/tt0082971/,https://raw.githubusercontent.com/eledah/imdb-delta/main/thumbnails/tt0082971.jpg,"Action, Adventure"
78,The Shining,65,129,-64,https://www.imdb.com/title/tt0081505/,https://raw.githubusercontent.com/eledah/imdb-delta/main/thumbnails/tt0081505.jpg,"Drama, Horror"
79,Apocalypse Now,54,225,-171,https://www.imdb.com/title/tt0078788/,https://raw.githubusercontent.com/eledah/imdb-delta/main/thumbnails/tt0078788.jpg,"Drama, Mystery, War"
80,Alien,45,164,-119,https://www.imdb.com/title/tt0078748/,https://raw.githubusercontent.com/eledah/imdb-delta/main/thumbnails/tt0078748.jpg,"Horror, Sci-Fi"
82,Dr. Strangelove or: How I Learned to Stop Worrying and Love the Bomb,66,272,-206,https://www.imdb.com/title/tt0057012/,https://raw.githubusercontent.com/eledah/imdb-delta/main/thumbnails/tt0057012.jpg,"Comedy, War"
83,Witness for the Prosecution,63,52,11,https://www.imdb.com/title/tt0051201/,https://raw.githubusercontent.com/eledah/imdb-delta/main/thumbnails/tt0051201.jpg,"Crime, Drama, Mystery"
84,Paths of Glory,61,245,-184,https://www.imdb.com/title/tt0050825/,https://raw.githubusercontent.com/eledah/imdb-delta/main/thumbnails/tt0050825.jpg,"Drama, War"
85,Rear Window,57,48,9,https://www.imdb.com/title/tt0047396/,https://raw.githubusercontent.com/eledah/imdb-delta/main/thumbnails/tt0047396.jpg,"Mystery, Thriller"
86,Sunset Blvd.,76,61,15,https://www.imdb.com/title/tt0043014/,https://raw.githubusercontent.com/eledah/imdb-delta/main/thumbnails/tt0043014.jpg,"Drama, Film-Noir"
87,The Great Dictator,60,42,18,https://www.imdb.com/title/tt0032553/,https://raw.githubusercontent.com/eledah/imdb-delta/main/thumbnails/tt0032553.jpg,"Comedy, Drama, War"
88,1917,128,122,6,https://www.imdb.com/title/tt8579674/,https://raw.githubusercontent.com/eledah/imdb-delta/main/thumbnails/tt8579674.jpg,"Action, Drama, History"
90,The Hunt,124,152,-28,https://www.imdb.com/title/tt2106476/,https://raw.githubusercontent.com/eledah/imdb-delta/main/thumbnails/tt2106476.jpg,Drama
91,A Separation,94,197,-103,https://www.imdb.com/title/tt1832382/,https://raw.githubusercontent.com/eledah/imdb-delta/main/thumbnails/tt1832382.jpg,Drama
92,Incendies,137,73,64,https://www.imdb.com/title/tt1255953/,https://raw.githubusercontent.com/eledah/imdb-delta/main/thumbnails/tt1255953.jpg,"Drama, Mystery, War"
96,Inglourious Basterds,107,101,6,https://www.imdb.com/title/tt0361748/,https://raw.githubusercontent.com/eledah/imdb-delta/main/thumbnails/tt0361748.jpg,"Adventure, Drama, War"
97,Eternal Sunshine of the Spotless Mind,122,106,16,https://www.imdb.com/title/tt0338013/,https://raw.githubusercontent.com/eledah/imdb-delta/main/thumbnails/tt0338013.jpg,"Drama, Romance, Sci-Fi"
98,Amélie,131,53,78,https://www.imdb.com/title/tt0211915/,https://raw.githubusercontent.com/eledah/imdb-delta/main/thumbnails/tt0211915.jpg,"Comedy, Romance"
99,Snatch,90,318,-228,https://www.imdb.com/title/tt0208092/,https://raw.githubusercontent.com/eledah/imdb-delta/main/thumbnails/tt0208092.jpg,"Comedy, Crime"
100,Requiem for a Dream,118,108,10,https://www.imdb.com/title/tt0180093/,https://raw.githubusercontent.com/eledah/imdb-delta/main/thumbnails/tt0180093.jpg,Drama
101,American Beauty,71,268,-197,https://www.imdb.com/title/tt0169547/,https://raw.githubusercontent.com/eledah/imdb-delta/main/thumbnails/tt0169547.jpg,Drama
102,Good Will Hunting,100,174,-74,https://www.imdb.com/title/tt0119217/,https://raw.githubusercontent.com/eledah/imdb-delta/main/thumbnails/tt0119217.jpg,"Drama, Romance"
104,Toy Story,80,169,-89,https://www.imdb.com/title/tt0114709/,https://raw.githubusercontent.com/eledah/imdb-delta/main/thumbnails/tt0114709.jpg,"Animation, Adventure, Comedy"
105,Braveheart,87,400,-313,https://www.imdb.com/title/tt0112573/,https://raw.githubusercontent.com/eledah/imdb-delta/main/thumbnails/tt0112573.jpg,"Biography, Drama, War"
106,Reservoir Dogs,97,257,-160,https://www.imdb.com/title/tt0105236/,https://raw.githubusercontent.com/eledah/imdb-delta/main/thumbnails/tt0105236.jpg,"Crime, Thriller"
107,Full Metal Jacket,114,295,-181,https://www.imdb.com/title/tt0093058/,https://raw.githubusercontent.com/eledah/imdb-delta/main/thumbnails/tt0093058.jpg,"Drama, War"
109,Aliens,72,258,-186,https://www.imdb.com/title/tt0090605/,https://raw.githubusercontent.com/eledah/imdb-delta/main/thumbnails/tt0090605.jpg,"Action, Adventure, Sci-Fi"
110,Amadeus,84,103,-19,https://www.imdb.com/title/tt0086879/,https://raw.githubusercontent.com/eledah/imdb-delta/main/thumbnails/tt0086879.jpg,"Biography, Drama, Music"
111,Scarface,105,411,-306,https://www.imdb.com/title/tt0086250/,https://raw.githubusercontent.com/eledah/imdb-delta/main/thumbnails/tt0086250.jpg,"Crime, Drama"
112,Star Wars: Episode VI - Return of the Jedi,83,110,-27,https://www.imdb.com/title/tt0086190/,https://raw.githubusercontent.com/eledah/imdb-delta/main/thumbnails/tt0086190.jpg,"Action, Adventure, Fantasy"
113,Das Boot,86,354,-268,https://www.imdb.com/title/tt0082096/,https://raw.githubusercontent.com/eledah/imdb-delta/main/thumbnails/tt0082096.jpg,"Drama, War"
114,The Sting,103,208,-105,https://www.imdb.com/title/tt0070735/,https://raw.githubusercontent.com/eledah/imdb-delta/main/thumbnails/tt0070735.jpg,"Comedy, Crime, Drama"
115,A Clockwork Orange,109,260,-151,https://www.imdb.com/title/tt0066921/,https://raw.githubusercontent.com/eledah/imdb-delta/main/thumbnails/tt0066921.jpg,"Crime, Sci-Fi"
117,2001: A Space Odyssey,82,479,-397,https://www.imdb.com/title/tt0062622/,https://raw.githubusercontent.com/eledah/imdb-delta/main/thumbnails/tt0062622.jpg,"Adventure, Sci-Fi"
118,Lawrence of Arabia,108,437,-329,https://www.imdb.com/title/tt0056172/,https://raw.githubusercontent.com/eledah/imdb-delta/main/thumbnails/tt0056172.jpg,"Adventure, Biography, Drama"
119,The Apartment,98,251,-153,https://www.imdb.com/title/tt0053604/,https://raw.githubusercontent.com/eledah/imdb-delta/main/thumbnails/tt0053604.jpg,"Comedy, Drama, Romance"
120,North by Northwest,115,184,-69,https://www.imdb.com/title/tt0053125/,https://raw.githubusercontent.com/eledah/imdb-delta/main/thumbnails/tt0053125.jpg,"Action, Adventure, Mystery"
121,Vertigo,92,162,-70,https://www.imdb.com/title/tt0052357/,https://raw.githubusercontent.com/eledah/imdb-delta/main/thumbnails/tt0052357.jpg,"Mystery, Romance, Thriller"
122,Singin' in the Rain,145,45,100,https://www.imdb.com/title/tt0045152/,https://raw.githubusercontent.com/eledah/imdb-delta/main/thumbnails/tt0045152.jpg,"Comedy, Musical, Romance"
124,Bicycle Thieves,102,153,-51,https://www.imdb.com/title/tt0040522/,https://raw.githubusercontent.com/eledah/imdb-delta/main/thumbnails/tt0040522.jpg,Drama
125,Double Indemnity,89,292,-203,https://www.imdb.com/title/tt0036775/,https://raw.githubusercontent.com/eledah/imdb-delta/main/thumbnails/tt0036775.jpg,"Crime, Drama, Film-Noir"
126,Citizen Kane,111,335,-224,https://www.imdb.com/title/tt0033467/,https://raw.githubusercontent.com/eledah/imdb-delta/main/thumbnails/tt0033467.jpg,"Drama, Mystery"
127,M,91,123,-32,https://www.imdb.com/title/tt0022100/,https://raw.githubusercontent.com/eledah/imdb-delta/main/thumbnails/tt0022100.jpg,"Crime, Mystery, Thriller"
128,Metropolis,132,124,8,https://www.imdb.com/title/tt0017136/,https://raw.githubusercontent.com/eledah/imdb-delta/main/thumbnails/tt0017136.jpg,"Drama, Sci-Fi"
129,The Kid,116,77,39,https://www.imdb.com/title/tt0012349/,https://raw.githubusercontent.com/eledah/imdb-delta/main/thumbnails/tt0012349.jpg,"Comedy, Drama, Family"
134,Green Book,175,89,86,https://www.imdb.com/title/tt6966692/,https://raw.githubusercontent.com/eledah/imdb-delta/main/thumbnails/tt6966692.jpg,"Biography, Comedy, Drama"
137,Klaus,298,62,236,https://www.imdb.com/title/tt4729430/,https://raw.githubusercontent.com/eledah/imdb-delta/main/thumbnails/tt4729430.jpg,"Animation, Adventure, Comedy"
146,The Secret in Their Eyes,152,176,-24,https://www.imdb.com/title/tt1305806/,https://raw.githubusercontent.com/eledah/imdb-delta/main/thumbnails/tt1305806.jpg,"Drama, Mystery, Romance"
147,Warrior,181,206,-25,https://www.imdb.com/title/tt1291584/,https://raw.githubusercontent.com/eledah/imdb-delta/main/thumbnails/tt1291584.jpg,"Action, Drama, Sport"
148,Shutter Island,176,196,-20,https://www.imdb.com/title/tt1130884/,https://raw.githubusercontent.com/eledah/imdb-delta/main/thumbnails/tt1130884.jpg,"Drama, Mystery, Thriller"
149,Up,151,69,82,https://www.imdb.com/title/tt1049413/,https://raw.githubusercontent.com/eledah/imdb-delta/main/thumbnails/tt1049413.jpg,"Animation, Adventure, Comedy"
151,The Wolf of Wall Street,125,656,-531,https://www.imdb.com/title/tt0993846/,https://raw.githubusercontent.com/eledah/imdb-delta/main/thumbnails/tt0993846.jpg,"Biography, Comedy, Crime"
153,There Will Be Blood,216,626,-410,https://www.imdb.com/title/tt0469494/,https://raw.githubusercontent.com/eledah/imdb-delta/main/thumbnails/tt0469494.jpg,Drama
154,Pan's Labyrinth,167,133,34,https://www.imdb.com/title/tt0457430/,https://raw.githubusercontent.com/eledah/imdb-delta/main/thumbnails/tt0457430.jpg,"Drama, Fantasy, War"
155,Toy Story 3,96,148,-52,https://www.imdb.com/title/tt0435761/,https://raw.githubusercontent.com/eledah/imdb-delta/main/thumbnails/tt0435761.jpg,"Animation, Adventure, Comedy"
156,V for Vendetta,169,218,-49,https://www.imdb.com/title/tt0434409/,https://raw.githubusercontent.com/eledah/imdb-delta/main/thumbnails/tt0434409.jpg,"Action, Drama, Sci-Fi"
157,Rang De Basanti,182,1063,-881,https://www.imdb.com/title/tt0405508/,https://raw.githubusercontent.com/eledah/imdb-delta/main/thumbnails/tt0405508.jpg,"Comedy, Crime, Drama"
159,Batman Begins,120,372,-252,https://www.imdb.com/title/tt0372784/,https://raw.githubusercontent.com/eledah/imdb-delta/main/thumbnails/tt0372784.jpg,"Action, Crime, Drama"
161,Downfall,138,326,-188,https://www.imdb.com/title/tt0363163/,https://raw.githubusercontent.com/eledah/imdb-delta/main/thumbnails/tt0363163.jpg,"Biography, Drama, History"
162,Howl's Moving Castle,318,27,291,https://www.imdb.com/title/tt0347149/,https://raw.githubusercontent.com/eledah/imdb-delta/main/thumbnails/tt0347149.jpg,"Animation, Adventure, Family"
163,A Beautiful Mind,154,150,4,https://www.imdb.com/title/tt0268978/,https://raw.githubusercontent.com/eledah/imdb-delta/main/thumbnails/tt0268978.jpg,"Biography, Drama, Mystery"
165,"Lock, Stock and Two Smoking Barrels",179,323,-144,https://www.imdb.com/title/tt0120735/,https://raw.githubusercontent.com/eledah/imdb-delta/main/thumbnails/tt0120735.jpg,"Action, Comedy, Crime"
166,L.A. Confidential,119,460,-341,https://www.imdb.com/title/tt0119488/,https://raw.githubusercontent.com/eledah/imdb-delta/main/thumbnails/tt0119488.jpg,"Crime, Drama, Mystery"
168,Heat,126,648,-522,https://www.imdb.com/title/tt0113277/,https://raw.githubusercontent.com/eledah/imdb-delta/main/thumbnails/tt0113277.jpg,"Action, Crime, Drama"
169,Casino,160,569,-409,https://www.imdb.com/title/tt0112641/,https://raw.githubusercontent.com/eledah/imdb-delta/main/thumbnails/tt0112641.jpg,"Crime, Drama"
171,Unforgiven,139,736,-597,https://www.imdb.com/title/tt0105695/,https://raw.githubusercontent.com/eledah/imdb-delta/main/thumbnails/tt0105695.jpg,"Drama, Western"
172,Indiana Jones and the Last Crusade,135,300,-165,https://www.imdb.com/title/tt0097576/,https://raw.githubusercontent.com/eledah/imdb-delta/main/thumbnails/tt0097576.jpg,"Action, Adventure"
174,My Neighbor Totoro,239,66,173,https://www.imdb.com/title/tt0096283/,https://raw.githubusercontent.com/eledah/imdb-delta/main/thumbnails/tt0096283.jpg,"Animation, Comedy, Family"
175,Die Hard,117,572,-455,https://www.imdb.com/title/tt0095016/,https://raw.githubusercontent.com/eledah/imdb-delta/main/thumbnails/tt0095016.jpg,"Action, Thriller"
176,Ran,140,347,-207,https://www.imdb.com/title/tt0089881/,https://raw.githubusercontent.com/eledah/imdb-delta/main/thumbnails/tt0089881.jpg,"Action, Drama, War"
177,Raging Bull,147,833,-686,https://www.imdb.com/title/tt0081398/,https://raw.githubusercontent.com/eledah/imdb-delta/main/thumbnails/tt0081398.jpg,"Biography, Drama, Sport"
178,Stalker,225,151,74,https://www.imdb.com/title/tt0079944/,https://raw.githubusercontent.com/eledah/imdb-delta/main/thumbnails/tt0079944.jpg,"Drama, Sci-Fi"
180,Taxi Driver,101,378,-277,https://www.imdb.com/title/tt0075314/,https://raw.githubusercontent.com/eledah/imdb-delta/main/thumbnails/tt0075314.jpg,"Crime, Drama"
183,Monty Python and the Holy Grail,144,199,-55,https://www.imdb.com/title/tt0071853/,https://raw.githubusercontent.com/eledah/imdb-delta/main/thumbnails/tt0071853.jpg,"Adventure, Comedy, Fantasy"
184,For a Few Dollars More,121,467,-346,https://www.imdb.com/title/tt0059578/,https://raw.githubusercontent.com/eledah/imdb-delta/main/thumbnails/tt0059578.jpg,"Drama, Western"
185,The Great Escape,142,312,-170,https://www.imdb.com/title/tt0057115/,https://raw.githubusercontent.com/eledah/imdb-delta/main/thumbnails/tt0057115.jpg,"Adventure, Drama, Thriller"
186,To Kill a Mockingbird,123,70,53,https://www.imdb.com/title/tt0056592/,https://raw.githubusercontent.com/eledah/imdb-delta/main/thumbnails/tt0056592.jpg,"Crime, Drama"
187,Yojimbo,113,507,-394,https://www.imdb.com/title/tt0055630/,https://raw.githubusercontent.com/eledah/imdb-delta/main/thumbnails/tt0055630.jpg,"Action, Drama, Thriller"
189,Some Like It Hot,173,93,80,https://www.imdb.com/title/tt0053291/,https://raw.githubusercontent.com/eledah/imdb-delta/main/thumbnails/tt0053291.jpg,"Comedy, Music, Romance"
191,The Seventh Seal,219,221,-2,https://www.imdb.com/title/tt0050976/,https://raw.githubusercontent.com/eledah/imdb-delta/main/thumbnails/tt0050976.jpg,"Drama, Fantasy"
192,Dial M for Murder,164,224,-60,https://www.imdb.com/title/tt0046912/,https://raw.githubusercontent.com/eledah/imdb-delta/main/thumbnails/tt0046912.jpg,"Crime, Thriller"
194,Rashomon,146,276,-130,https://www.imdb.com/title/tt0042876/,https://raw.githubusercontent.com/eledah/imdb-delta/main/thumbnails/tt0042876.jpg,"Crime, Drama, Mystery"
195,All About Eve,162,46,116,https://www.imdb.com/title/tt0042192/,https://raw.githubusercontent.com/eledah/imdb-delta/main/thumbnails/tt0042192.jpg,Drama
196,The Treasure of the Sierra Madre,141,484,-343,https://www.imdb.com/title/tt0040897/,https://raw.githubusercontent.com/eledah/imdb-delta/main/thumbnails/tt0040897.jpg,"Adventure, Drama, Western"
198,The Gold Rush,190,279,-89,https://www.imdb.com/title/tt0015864/,https://raw.githubusercontent.com/eledah/imdb-delta/main/thumbnails/tt0015864.jpg,"Adventure, Comedy, Drama"
203,"Three Billboards Outside Ebbing, Missouri",253,190,63,https://www.imdb.com/title/tt5027774/,https://raw.githubusercontent.com/eledah/imdb-delta/main/thumbnails/tt5027774.jpg,"Comedy, Crime, Drama"
204,The Invisible Guest,407,171,236,https://www.imdb.com/title/tt4857264/,https://raw.githubusercontent.com/eledah/imdb-delta/main/thumbnails/tt4857264.jpg,"Crime, Drama, Mystery"
205,The Handmaiden,281,185,96,https://www.imdb.com/title/tt4016934/,https://raw.githubusercontent.com/eledah/imdb-delta/main/thumbnails/tt4016934.jpg,"Drama, Romance, Thriller"
209,Logan,345,510,-165,https://www.imdb.com/title/tt3315342/,https://raw.githubusercontent.com/eledah/imdb-delta/main/thumbnails/tt3315342.jpg,"Action, Drama, Sci-Fi"
210,Room,254,125,129,https://www.imdb.com/title/tt3170832/,https://raw.githubusercontent.com/eledah/imdb-delta/main/thumbnails/tt3170832.jpg,"Drama, Thriller"
211,Wild Tales,214,157,57,https://www.imdb.com/title/tt3011894/,https://raw.githubusercontent.com/eledah/imdb-delta/main/thumbnails/tt3011894.jpg,"Comedy, Drama, Thriller"
212,Soul,400,192,208,https://www.imdb.com/title/tt2948372/,https://raw.githubusercontent.com/eledah/imdb-delta/main/thumbnails/tt2948372.jpg,"Animation, Adventure, Comedy"
215,PK,246,336,-90,https://www.imdb.com/title/tt2338151/,https://raw.githubusercontent.com/eledah/imdb-delta/main/thumbnails/tt2338151.jpg,"Comedy, Drama, Sci-Fi"
217,The Grand Budapest Hotel,274,212,62,https://www.imdb.com/title/tt2278388/,https://raw.githubusercontent.com/eledah/imdb-delta/main/thumbnails/tt2278388.jpg,"Adventure, Comedy, Crime"
218,Gone Girl,184,285,-101,https://www.imdb.com/title/tt2267998/,https://raw.githubusercontent.com/eledah/imdb-delta/main/thumbnails/tt2267998.jpg,"Drama, Mystery, Thriller"
221,Hacksaw Ridge,292,114,178,https://www.imdb.com/title/tt2119532/,https://raw.githubusercontent.com/eledah/imdb-delta/main/thumbnails/tt2119532.jpg,"Biography, Drama, History"
222,Inside Out,186,160,26,https://www.imdb.com/title/tt2096673/,https://raw.githubusercontent.com/eledah/imdb-delta/main/thumbnails/tt2096673.jpg,"Animation, Adventure, Comedy"
224,12 Years a Slave,271,242,29,https://www.imdb.com/title/tt2024544/,https://raw.githubusercontent.com/eledah/imdb-delta/main/thumbnails/tt2024544.jpg,"Biography, Drama, History"
225,Rush,215,341,-126,https://www.imdb.com/title/tt1979320/,https://raw.githubusercontent.com/eledah/imdb-delta/main/thumbnails/tt1979320.jpg,"Action, Biography, Drama"
226,Ford v Ferrari,301,296,5,https://www.imdb.com/title/tt1950186/,https://raw.githubusercontent.com/eledah/imdb-delta/main/thumbnails/tt1950186.jpg,"Action, Biography, Drama"
227,Spotlight,283,262,21,https://www.imdb.com/title/tt1895587/,https://raw.githubusercontent.com/eledah/imdb-delta/main/thumbnails/tt1895587.jpg,"Biography, Crime, Drama"
230,Prisoners,266,404,-138,https://www.imdb.com/title/tt1392214/,https://raw.githubusercontent.com/eledah/imdb-delta/main/thumbnails/tt1392214.jpg,"Crime, Drama, Mystery"
231,Mad Max: Fury Road,237,564,-327,https://www.imdb.com/title/tt1392190/,https://raw.githubusercontent.com/eledah/imdb-delta/main/thumbnails/tt1392190.jpg,"Action, Adventure, Sci-Fi"
233,Zack Snyder's Justice League,279,387,-108,https://www.imdb.com/title/tt12361974/,https://raw.githubusercontent.com/eledah/imdb-delta/main/thumbnails/tt12361974.jpg,"Action, Adventure, Fantasy"
234,Gran Torino,227,246,-19,https://www.imdb.com/title/tt1205489/,https://raw.githubusercontent.com/eledah/imdb-delta/main/thumbnails/tt1205489.jpg,Drama
235,Harry Potter and the Deathly Hallows: Part 2,442,35,407,https://www.imdb.com/title/tt1201607/,https://raw.githubusercontent.com/eledah/imdb-delta/main/thumbnails/tt1201607.jpg,"Adventure, Family, Fantasy"
237,Hachi: A Dog's Tale,316,83,233,https://www.imdb.com/title/tt1028532/,https://raw.githubusercontent.com/eledah/imdb-delta/main/thumbnails/tt1028532.jpg,"Biography, Drama, Family"
238,Mary and Max,310,74,236,https://www.imdb.com/title/tt0978762/,https://raw.githubusercontent.com/eledah/imdb-delta/main/thumbnails/tt0978762.jpg,"Animation, Comedy, Drama"
239,How to Train Your Dragon,355,63,292,https://www.imdb.com/title/tt0892769/,https://raw.githubusercontent.com/eledah/imdb-delta/main/thumbnails/tt0892769.jpg,"Animation, Action, Adventure"
240,Into the Wild,262,264,-2,https://www.imdb.com/title/tt0758758/,https://raw.githubusercontent.com/eledah/imdb-delta/main/thumbnails/tt0758758.jpg,"Adventure, Biography, Drama"
241,No Country for Old Men,208,799,-591,https://www.imdb.com/title/tt0477348/,https://raw.githubusercontent.com/eledah/imdb-delta/main/thumbnails/tt0477348.jpg,"Crime, Drama, Thriller"
244,Million Dollar Baby,230,343,-113,https://www.imdb.com/title/tt0405159/,https://raw.githubusercontent.com/eledah/imdb-delta/main/thumbnails/tt0405159.jpg,"Drama, Sport"
245,Hotel Rwanda,297,175,122,https://www.imdb.com/title/tt0395169/,https://raw.githubusercontent.com/eledah/imdb-delta/main/thumbnails/tt0395169.jpg,"Biography, Drama, History"
247,Before Sunset,352,463,-111,https://www.imdb.com/title/tt0381681/,https://raw.githubusercontent.com/eledah/imdb-delta/main/thumbnails/tt0381681.jpg,"Drama, Romance"
249,Memories of Murder,197,465,-268,https://www.imdb.com/title/tt0353969/,https://raw.githubusercontent.com/eledah/imdb-delta/main/thumbnails/tt0353969.jpg,"Crime, Drama, Mystery"
251,Kill Bill: Vol. 1,250,293,-43,https://www.imdb.com/title/tt0266697/,https://raw.githubusercontent.com/eledah/imdb-delta/main/thumbnails/tt0266697.jpg,"Action, Crime, Thriller"
252,Finding Nemo,287,107,180,https://www.imdb.com/title/tt0266543/,https://raw.githubusercontent.com/eledah/imdb-delta/main/thumbnails/tt0266543.jpg,"Animation, Adventure, Comedy"
253,Catch Me If You Can,317,305,12,https://www.imdb.com/title/tt0264464/,https://raw.githubusercontent.com/eledah/imdb-delta/main/thumbnails/tt0264464.jpg,"Biography, Crime, Drama"
254,Amores Perros,260,291,-31,https://www.imdb.com/title/tt0245712/,https://raw.githubusercontent.com/eledah/imdb-delta/main/thumbnails/tt0245712.jpg,"Drama, Thriller"
255,"Monsters, Inc.",402,149,253,https://www.imdb.com/title/tt0198781/,https://raw.githubusercontent.com/eledah/imdb-delta/main/thumbnails/tt0198781.jpg,"Animation, Adventure, Comedy"
257,Lagaan: Once Upon a Time in India,280,827,-547,https://www.imdb.com/title/tt0169102/,https://raw.githubusercontent.com/eledah/imdb-delta/main/thumbnails/tt0169102.jpg,"Drama, Musical, Sport"
258,The Sixth Sense,200,204,-4,https://www.imdb.com/title/tt0167404/,https://raw.githubusercontent.com/eledah/imdb-delta/main/thumbnails/tt0167404.jpg,"Drama, Mystery, Thriller"
260,The Truman Show,221,356,-135,https://www.imdb.com/title/tt0120382/,https://raw.githubusercontent.com/eledah/imdb-delta/main/thumbnails/tt0120382.jpg,"Comedy, Drama"
262,The Big Lebowski,174,733,-559,https://www.imdb.com/title/tt0118715/,https://raw.githubusercontent.com/eledah/imdb-delta/main/thumbnails/tt0118715.jpg,"Comedy, Crime"
263,In the Mood for Love,330,188,142,https://www.imdb.com/title/tt0118694/,https://raw.githubusercontent.com/eledah/imdb-delta/main/thumbnails/tt0118694.jpg,"Drama, Romance"
264,Trainspotting,231,267,-36,https://www.imdb.com/title/tt0117951/,https://raw.githubusercontent.com/eledah/imdb-delta/main/thumbnails/tt0117951.jpg,Drama
265,Fargo,195,408,-213,https://www.imdb.com/title/tt0116282/,https://raw.githubusercontent.com/eledah/imdb-delta/main/thumbnails/tt0116282.jpg,"Crime, Thriller"
267,La Haine,278,350,-72,https://www.imdb.com/title/tt0113247/,https://raw.githubusercontent.com/eledah/imdb-delta/main/thumbnails/tt0113247.jpg,"Crime, Drama"
269,Before Sunrise,249,309,-60,https://www.imdb.com/title/tt0112471/,https://raw.githubusercontent.com/eledah/imdb-delta/main/thumbnails/tt0112471.jpg,"Drama, Romance"
272,Jurassic Park,205,431,-226,https://www.imdb.com/title/tt0107290/,https://raw.githubusercontent.com/eledah/imdb-delta/main/thumbnails/tt0107290.jpg,"Action, Adventure, Sci-Fi"
273,In the Name of the Father,252,210,42,https://www.imdb.com/title/tt0107207/,https://raw.githubusercontent.com/eledah/imdb-delta/main/thumbnails/tt0107207.jpg,"Biography, Crime, Drama"
276,Dead Poets Society,408,130,278,https://www.imdb.com/title/tt0097165/,https://raw.githubusercontent.com/eledah/imdb-delta/main/thumbnails/tt0097165.jpg,"Comedy, Drama"
277,Stand by Me,366,145,221,https://www.imdb.com/title/tt0092005/,https://raw.githubusercontent.com/eledah/imdb-delta/main/thumbnails/tt0092005.jpg,"Adventure, Comedy, Drama"
278,Platoon,259,619,-360,https://www.imdb.com/title/tt0091763/,https://raw.githubusercontent.com/eledah/imdb-delta/main/thumbnails/tt0091763.jpg,"Drama, War"
281,Nausicaä of the Valley of the Wind,270,287,-17,https://www.imdb.com/title/tt0087544/,https://raw.githubusercontent.com/eledah/imdb-delta/main/thumbnails/tt0087544.jpg,"Animation, Adventure, Sci-Fi"
282,The Thing,199,785,-586,https://www.imdb.com/title/tt0084787/,https://raw.githubusercontent.com/eledah/imdb-delta/main/thumbnails/tt0084787.jpg,"Horror, Mystery, Sci-Fi"
286,Blade Runner,155,643,-488,https://www.imdb.com/title/tt0083658/,https://raw.githubusercontent.com/eledah/imdb-delta/main/thumbnails/tt0083658.jpg,"Action, Drama, Sci-Fi"
287,The Elephant Man,202,159,43,https://www.imdb.com/title/tt0080678/,https://raw.githubusercontent.com/eledah/imdb-delta/main/thumbnails/tt0080678.jpg,"Biography, Drama"
288,Monty Python's Life of Brian,234,409,-175,https://www.imdb.com/title/tt0079470/,https://raw.githubusercontent.com/eledah/imdb-delta/main/thumbnails/tt0079470.jpg,Comedy
289,The Deer Hunter,198,294,-96,https://www.imdb.com/title/tt0077416/,https://raw.githubusercontent.com/eledah/imdb-delta/main/thumbnails/tt0077416.jpg,"Drama, War"
290,Rocky,261,1073,-812,https://www.imdb.com/title/tt0075148/,https://raw.githubusercontent.com/eledah/imdb-delta/main/thumbnails/tt0075148.jpg,"Drama, Sport"
291,Network,251,480,-229,https://www.imdb.com/title/tt0074958/,https://raw.githubusercontent.com/eledah/imdb-delta/main/thumbnails/tt0074958.jpg,Drama
292,Barry Lyndon,228,888,-660,https://www.imdb.com/title/tt0072684/,https://raw.githubusercontent.com/eledah/imdb-delta/main/thumbnails/tt0072684.jpg,"Adventure, Drama, War"
294,Chinatown,196,527,-331,https://www.imdb.com/title/tt0071315/,https://raw.githubusercontent.com/eledah/imdb-delta/main/thumbnails/tt0071315.jpg,"Drama, Mystery, Thriller"
299,Cool Hand Luke,206,421,-215,https://www.imdb.com/title/tt0061512/,https://raw.githubusercontent.com/eledah/imdb-delta/main/thumbnails/tt0061512.jpg,"Crime, Drama"
300,Persona,302,186,116,https://www.imdb.com/title/tt0060827/,https://raw.githubusercontent.com/eledah/imdb-delta/main/thumbnails/tt0060827.jpg,"Drama, Thriller"
310,The 400 Blows,305,273,32,https://www.imdb.com/title/tt0053198/,https://raw.githubusercontent.com/eledah/imdb-delta/main/thumbnails/tt0053198.jpg,"Crime, Drama"
311,Ben-Hur,210,578,-368,https://www.imdb.com/title/tt0052618/,https://raw.githubusercontent.com/eledah/imdb-delta/main/thumbnails/tt0052618.jpg,"Adventure, Drama"
315,The Bridge on the River Kwai,189,447,-258,https://www.imdb.com/title/tt0050212/,https://raw.githubusercontent.com/eledah/imdb-delta/main/thumbnails/tt0050212.jpg,"Adventure, Drama, War"
317,On the Waterfront,193,320,-127,https://www.imdb.com/title/tt0047296/,https://raw.githubusercontent.com/eledah/imdb-delta/main/thumbnails/tt0047296.jpg,"Crime, Drama, Thriller"
321,The Third Man,177,314,-137,https://www.imdb.com/title/tt0041959/,https://raw.githubusercontent.com/eledah/imdb-delta/main/thumbnails/tt0041959.jpg,"Film-Noir, Mystery, Thriller"
324,Rebecca,327,131,196,https://www.imdb.com/title/tt0032976/,https://raw.githubusercontent.com/eledah/imdb-delta/main/thumbnails/tt0032976.jpg,"Drama, Mystery, Romance"
325,Mr. Smith Goes to Washington,209,222,-13,https://www.imdb.com/title/tt0031679/,https://raw.githubusercontent.com/eledah/imdb-delta/main/thumbnails/tt0031679.jpg,"Comedy, Drama"
326,Gone with the Wind,324,39,285,https://www.imdb.com/title/tt0031381/,https://raw.githubusercontent.com/eledah/imdb-delta/main/thumbnails/tt0031381.jpg,"Drama, Romance, War"
339,La La Land,339,694,-355,https://www.imdb.com/title/tt3783958/,https://raw.githubusercontent.com/eledah/imdb-delta/main/thumbnails/tt3783958.jpg,"Comedy, Drama, Music"
340,Lion,463,116,347,https://www.imdb.com/title/tt3741834/,https://raw.githubusercontent.com/eledah/imdb-delta/main/thumbnails/tt3741834.jpg,"Biography, Drama"
341,The Martian,421,407,14,https://www.imdb.com/title/tt3659388/,https://raw.githubusercontent.com/eledah/imdb-delta/main/thumbnails/tt3659388.jpg,"Adventure, Drama, Sci-Fi"
342,Zootopia,433,191,242,https://www.imdb.com/title/tt2948356/,https://raw.githubusercontent.com/eledah/imdb-delta/main/thumbnails/tt2948356.jpg,"Animation, Action, Adventure"
343,Baahubali: The Beginning,429,853,-424,https://www.imdb.com/title/tt2631186/,https://raw.githubusercontent.com/eledah/imdb-delta/main/thumbnails/tt2631186.jpg,"Action, Drama"
345,Wonder,560,229,331,https://www.imdb.com/title/tt2543472/,https://raw.githubusercontent.com/eledah/imdb-delta/main/thumbnails/tt2543472.jpg,"Drama, Family"
349,The Raid 2,445,828,-383,https://www.imdb.com/title/tt2265171/,https://raw.githubusercontent.com/eledah/imdb-delta/main/thumbnails/tt2265171.jpg,"Action, Crime, Thriller"
350,The Imitation Game,416,118,298,https://www.imdb.com/title/tt2084970/,https://raw.githubusercontent.com/eledah/imdb-delta/main/thumbnails/tt2084970.jpg,"Biography, Drama, Thriller"
351,Guardians of the Galaxy,338,328,10,https://www.imdb.com/title/tt2015381/,https://raw.githubusercontent.com/eledah/imdb-delta/main/thumbnails/tt2015381.jpg,"Action, Adventure, Comedy"
352,Blade Runner 2049,393,978,-585,https://www.imdb.com/title/tt1856101/,https://raw.githubusercontent.com/eledah/imdb-delta/main/thumbnails/tt1856101.jpg,"Action, Drama, Mystery"
353,Her,311,800,-489,https://www.imdb.com/title/tt1798709/,https://raw.githubusercontent.com/eledah/imdb-delta/main/thumbnails/tt1798709.jpg,"Drama, Romance, Sci-Fi"
354,Bohemian Rhapsody,607,75,532,https://www.imdb.com/title/tt1727824/,https://raw.githubusercontent.com/eledah/imdb-delta/main/thumbnails/tt1727824.jpg,"Biography, Drama, Music"
355,The Revenant,387,723,-336,https://www.imdb.com/title/tt1663202/,https://raw.githubusercontent.com/eledah/imdb-delta/main/thumbnails/tt1663202.jpg,"Action, Adventure, Drama"
356,The Perks of Being a Wallflower,499,339,160,https://www.imdb.com/title/tt1659337/,https://raw.githubusercontent.com/eledah/imdb-delta/main/thumbnails/tt1659337.jpg,Drama
358,The King's Speech,464,168,296,https://www.imdb.com/title/tt1504320/,https://raw.githubusercontent.com/eledah/imdb-delta/main/thumbnails/tt1504320.jpg,"Biography, Drama, History"
359,The Help,487,82,405,https://www.imdb.com/title/tt1454029/,https://raw.githubusercontent.com/eledah/imdb-delta/main/thumbnails/tt1454029.jpg,Drama
360,Deadpool,424,416,8,https://www.imdb.com/title/tt1431045/,https://raw.githubusercontent.com/eledah/imdb-delta/main/thumbnails/tt1431045.jpg,"Action, Comedy"
363,Yip Man,361,545,-184,https://www.imdb.com/title/tt1220719/,https://raw.githubusercontent.com/eledah/imdb-delta/main/thumbnails/tt1220719.jpg,"Action, Biography, Drama"
366,Slumdog Millionaire,385,286,99,https://www.imdb.com/title/tt1010048/,https://raw.githubusercontent.com/eledah/imdb-delta/main/thumbnails/tt1010048.jpg,"Crime, Drama, Romance"
367,Black Swan,419,410,9,https://www.imdb.com/title/tt0947798/,https://raw.githubusercontent.com/eledah/imdb-delta/main/thumbnails/tt0947798.jpg,"Drama, Thriller"
369,The Avengers,383,220,163,https://www.imdb.com/title/tt0848228/,https://raw.githubusercontent.com/eledah/imdb-delta/main/thumbnails/tt0848228.jpg,"Action, Sci-Fi"
371,Dallas Buyers Club,437,349,88,https://www.imdb.com/title/tt0790636/,https://raw.githubusercontent.com/eledah/imdb-delta/main/thumbnails/tt0790636.jpg,"Biography, Drama"
372,The Pursuit of Happyness,451,450,1,https://www.imdb.com/title/tt0454921/,https://raw.githubusercontent.com/eledah/imdb-delta/main/thumbnails/tt0454921.jpg,"Biography, Drama"
373,Blood Diamond,364,389,-25,https://www.imdb.com/title/tt0450259/,https://raw.githubusercontent.com/eledah/imdb-delta/main/thumbnails/tt0450259.jpg,"Adventure, Drama, Thriller"
374,The Bourne Ultimatum,359,610,-251,https://www.imdb.com/title/tt0440963/,https://raw.githubusercontent.com/eledah/imdb-delta/main/thumbnails/tt0440963.jpg,"Action, Mystery, Thriller"
376,Sin City,328,956,-628,https://www.imdb.com/title/tt0401792/,https://raw.githubusercontent.com/eledah/imdb-delta/main/thumbnails/tt0401792.jpg,"Crime, Thriller"
377,The Diving Bell and the Butterfly,395,310,85,https://www.imdb.com/title/tt0401383/,https://raw.githubusercontent.com/eledah/imdb-delta/main/thumbnails/tt0401383.jpg,"Biography, Drama"
379,Ratatouille,363,357,6,https://www.imdb.com/title/tt0382932/,https://raw.githubusercontent.com/eledah/imdb-delta/main/thumbnails/tt0382932.jpg,"Animation, Adventure, Comedy"
380,Casino Royale,443,885,-442,https://www.imdb.com/title/tt0381061/,https://raw.githubusercontent.com/eledah/imdb-delta/main/thumbnails/tt0381061.jpg,"Action, Adventure, Thriller"
381,Kill Bill: Vol. 2,461,355,106,https://www.imdb.com/title/tt0378194/,https://raw.githubusercontent.com/eledah/imdb-delta/main/thumbnails/tt0378194.jpg,"Action, Crime, Thriller"
385,Cinderella Man,371,573,-202,https://www.imdb.com/title/tt0352248/,https://raw.githubusercontent.com/eledah/imdb-delta/main/thumbnails/tt0352248.jpg,"Biography, Drama, Romance"
386,Infernal Affairs,314,394,-80,https://www.imdb.com/title/tt0338564/,https://raw.githubusercontent.com/eledah/imdb-delta/main/thumbnails/tt0338564.jpg,"Action, Crime, Drama"
387,Pirates of the Caribbean: The Curse of the Black Pearl,423,214,209,https://www.imdb.com/title/tt0325980/,https://raw.githubusercontent.com/eledah/imdb-delta/main/thumbnails/tt0325980.jpg,"Action, Adventure, Fantasy"
388,Big Fish,450,284,166,https://www.imdb.com/title/tt0319061/,https://raw.githubusercontent.com/eledah/imdb-delta/main/thumbnails/tt0319061.jpg,"Adventure, Drama, Fantasy"
389,The Incredibles,388,678,-290,https://www.imdb.com/title/tt0317705/,https://raw.githubusercontent.com/eledah/imdb-delta/main/thumbnails/tt0317705.jpg,"Animation, Action, Adventure"
391,Dogville,444,234,210,https://www.imdb.com/title/tt0276919/,https://raw.githubusercontent.com/eledah/imdb-delta/main/thumbnails/tt0276919.jpg,"Crime, Drama"
393,Donnie Darko,358,353,5,https://www.imdb.com/title/tt0246578/,https://raw.githubusercontent.com/eledah/imdb-delta/main/thumbnails/tt0246578.jpg,"Drama, Mystery, Sci-Fi"
394,Magnolia,372,855,-483,https://www.imdb.com/title/tt0175880/,https://raw.githubusercontent.com/eledah/imdb-delta/main/thumbnails/tt0175880.jpg,Drama
395,Dancer in the Dark,489,346,143,https://www.imdb.com/title/tt0168629/,https://raw.githubusercontent.com/eledah/imdb-delta/main/thumbnails/tt0168629.jpg,"Crime, Drama, Musical"
400,The Iron Giant,389,414,-25,https://www.imdb.com/title/tt0129167/,https://raw.githubusercontent.com/eledah/imdb-delta/main/thumbnails/tt0129167.jpg,"Animation, Action, Adventure"
404,12 Monkeys,300,547,-247,https://www.imdb.com/title/tt0114746/,https://raw.githubusercontent.com/eledah/imdb-delta/main/thumbnails/tt0114746.jpg,"Mystery, Sci-Fi, Thriller"
405,Ghost in the Shell,405,712,-307,https://www.imdb.com/title/tt0113568/,https://raw.githubusercontent.com/eledah/imdb-delta/main/thumbnails/tt0113568.jpg,"Animation, Action, Crime"
406,The Nightmare Before Christmas,522,140,382,https://www.imdb.com/title/tt0107688/,https://raw.githubusercontent.com/eledah/imdb-delta/main/thumbnails/tt0107688.jpg,"Animation, Family, Fantasy"
407,Groundhog Day,236,1029,-793,https://www.imdb.com/title/tt0107048/,https://raw.githubusercontent.com/eledah/imdb-delta/main/thumbnails/tt0107048.jpg,"Comedy, Drama, Fantasy"
409,Scent of a Woman,384,383,1,https://www.imdb.com/title/tt0105323/,https://raw.githubusercontent.com/eledah/imdb-delta/main/thumbnails/tt0105323.jpg,Drama
410,Aladdin,418,177,241,https://www.imdb.com/title/tt0103639/,https://raw.githubusercontent.com/eledah/imdb-delta/main/thumbnails/tt0103639.jpg,"Animation, Adventure, Comedy"
411,JFK,340,741,-401,https://www.imdb.com/title/tt0102138/,https://raw.githubusercontent.com/eledah/imdb-delta/main/thumbnails/tt0102138.jpg,"Drama, History, Thriller"
412,Beauty and the Beast,635,40,595,https://www.imdb.com/title/tt0101414/,https://raw.githubusercontent.com/eledah/imdb-delta/main/thumbnails/tt0101414.jpg,"Animation, Family, Fantasy"
413,Dances with Wolves,354,560,-206,https://www.imdb.com/title/tt0099348/,https://raw.githubusercontent.com/eledah/imdb-delta/main/thumbnails/tt0099348.jpg,"Adventure, Drama, Western"
415,Rain Man,370,365,5,https://www.imdb.com/title/tt0095953/,https://raw.githubusercontent.com/eledah/imdb-delta/main/thumbnails/tt0095953.jpg,Drama
416,Akira,378,709,-331,https://www.imdb.com/title/tt0094625/,https://raw.githubusercontent.com/eledah/imdb-delta/main/thumbnails/tt0094625.jpg,"Animation, Action, Drama"
417,The Princess Bride,398,170,228,https://www.imdb.com/title/tt0093779/,https://raw.githubusercontent.com/eledah/imdb-delta/main/thumbnails/tt0093779.jpg,"Adventure, Comedy, Family"
420,Castle in the Sky,374,412,-38,https://www.imdb.com/title/tt0092067/,https://raw.githubusercontent.com/eledah/imdb-delta/main/thumbnails/tt0092067.jpg,"Animation, Adventure, Family"
421,The Terminator,248,826,-578,https://www.imdb.com/title/tt0088247/,https://raw.githubusercontent.com/eledah/imdb-delta/main/thumbnails/tt0088247.jpg,"Action, Adventure, Sci-Fi"
422,Gandhi,334,440,-106,https://www.imdb.com/title/tt0083987/,https://raw.githubusercontent.com/eledah/imdb-delta/main/thumbnails/tt0083987.jpg,"Biography, Drama, History"
425,Annie Hall,368,725,-357,https://www.imdb.com/title/tt0075686/,https://raw.githubusercontent.com/eledah/imdb-delta/main/thumbnails/tt0075686.jpg,"Comedy, Romance"
426,Jaws,272,949,-677,https://www.imdb.com/title/tt0073195/,https://raw.githubusercontent.com/eledah/imdb-delta/main/thumbnails/tt0073195.jpg,"Adventure, Drama, Thriller"
427,Dog Day Afternoon,341,369,-28,https://www.imdb.com/title/tt0072890/,https://raw.githubusercontent.com/eledah/imdb-delta/main/thumbnails/tt0072890.jpg,"Biography, Crime, Drama"
428,Young Frankenstein,365,261,104,https://www.imdb.com/title/tt0072431/,https://raw.githubusercontent.com/eledah/imdb-delta/main/thumbnails/tt0072431.jpg,Comedy
429,Papillon,325,477,-152,https://www.imdb.com/title/tt0070511/,https://raw.githubusercontent.com/eledah/imdb-delta/main/thumbnails/tt0070511.jpg,"Biography, Crime, Drama"
430,The Exorcist,309,676,-367,https://www.imdb.com/title/tt0070047/,https://raw.githubusercontent.com/eledah/imdb-delta/main/thumbnails/tt0070047.jpg,Horror
435,Butch Cassidy and the Sundance Kid,304,344,-40,https://www.imdb.com/title/tt0064115/,https://raw.githubusercontent.com/eledah/imdb-delta/main/thumbnails/tt0064115.jpg,"Biography, Crime, Drama"
436,Rosemary's Baby,351,605,-254,https://www.imdb.com/title/tt0063522/,https://raw.githubusercontent.com/eledah/imdb-delta/main/thumbnails/tt0063522.jpg,"Drama, Horror"
437,Planet of the Apes,427,870,-443,https://www.imdb.com/title/tt0063442/,https://raw.githubusercontent.com/eledah/imdb-delta/main/thumbnails/tt0063442.jpg,"Adventure, Sci-Fi"
438,The Graduate,343,636,-293,https://www.imdb.com/title/tt0061722/,https://raw.githubusercontent.com/eledah/imdb-delta/main/thumbnails/tt0061722.jpg,"Comedy, Drama, Romance"
440,The Sound of Music,579,86,493,https://www.imdb.com/title/tt0059742/,https://raw.githubusercontent.com/eledah/imdb-delta/main/thumbnails/tt0059742.jpg,"Biography, Drama, Family"
442,A Fistful of Dollars,392,881,-489,https://www.imdb.com/title/tt0058461/,https://raw.githubusercontent.com/eledah/imdb-delta/main/thumbnails/tt0058461.jpg,"Action, Drama, Western"
443,8½,342,333,9,https://www.imdb.com/title/tt0056801/,https://raw.githubusercontent.com/eledah/imdb-delta/main/thumbnails/tt0056801.jpg,Drama
457,Roman Holiday,457,211,246,https://www.imdb.com/title/tt0046250/,https://raw.githubusercontent.com/eledah/imdb-delta/main/thumbnails/tt0046250.jpg,"Comedy, Drama, Romance"
458,A Streetcar Named Desire,446,249,197,https://www.imdb.com/title/tt0044081/,https://raw.githubusercontent.com/eledah/imdb-delta/main/thumbnails/tt0044081.jpg,Drama
461,Rope,401,403,-2,https://www.imdb.com/title/tt0040746/,https://raw.githubusercontent.com/eledah/imdb-delta/main/thumbnails/tt0040746.jpg,"Crime, Drama, Mystery"
467,The Maltese Falcon,346,587,-241,https://www.imdb.com/title/tt0033870/,https://raw.githubusercontent.com/eledah/imdb-delta/main/thumbnails/tt0033870.jpg,"Crime, Film-Noir, Mystery"
469,The Wizard of Oz,394,180,214,https://www.imdb.com/title/tt0032138/,https://raw.githubusercontent.com/eledah/imdb-delta/main/thumbnails/tt0032138.jpg,"Adventure, Family, Fantasy"
474,Knives Out,532,734,-202,https://www.imdb.com/title/tt8946378/,https://raw.githubusercontent.com/eledah/imdb-delta/main/thumbnails/tt8946378.jpg,"Comedy, Crime, Drama"
476,Marriage Story,481,762,-281,https://www.imdb.com/title/tt7653254/,https://raw.githubusercontent.com/eledah/imdb-delta/main/thumbnails/tt7653254.jpg,"Drama, Romance"
477,Call Me by Your Name,794,167,627,https://www.imdb.com/title/tt5726616/,https://raw.githubusercontent.com/eledah/imdb-delta/main/thumbnails/tt5726616.jpg,"Drama, Romance"
479,Isle of Dogs,654,376,278,https://www.imdb.com/title/tt5104604/,https://raw.githubusercontent.com/eledah/imdb-delta/main/thumbnails/tt5104604.jpg,"Animation, Adventure, Comedy"
480,Hunt for the Wilderpeople,712,237,475,https://www.imdb.com/title/tt4698684/,https://raw.githubusercontent.com/eledah/imdb-delta/main/thumbnails/tt4698684.jpg,"Adventure, Comedy, Drama"
481,Captain Fantastic,578,442,136,https://www.imdb.com/title/tt3553976/,https://raw.githubusercontent.com/eledah/imdb-delta/main/thumbnails/tt3553976.jpg,"Comedy, Drama"
483,Thor: Ragnarok,587,329,258,https://www.imdb.com/title/tt3501632/,https://raw.githubusercontent.com/eledah/imdb-delta/main/thumbnails/tt3501632.jpg,"Action, Adventure, Comedy"
484,Jojo Rabbit,591,230,361,https://www.imdb.com/title/tt2584384/,https://raw.githubusercontent.com/eledah/imdb-delta/main/thumbnails/tt2584384.jpg,"Comedy, Drama, War"
485,Arrival,516,474,42,https://www.imdb.com/title/tt2543164/,https://raw.githubusercontent.com/eledah/imdb-delta/main/thumbnails/tt2543164.jpg,"Drama, Mystery, Sci-Fi"
486,Star Wars: Episode VII - The Force Awakens,571,233,338,https://www.imdb.com/title/tt2488496/,https://raw.githubusercontent.com/eledah/imdb-delta/main/thumbnails/tt2488496.jpg,"Action, Adventure, Sci-Fi"
487,Before Midnight,475,811,-336,https://www.imdb.com/title/tt2209418/,https://raw.githubusercontent.com/eledah/imdb-delta/main/thumbnails/tt2209418.jpg,"Drama, Romance"
489,X-Men: Days of Future Past,447,316,131,https://www.imdb.com/title/tt1877832/,https://raw.githubusercontent.com/eledah/imdb-delta/main/thumbnails/tt1877832.jpg,"Action, Adventure, Sci-Fi"
492,The Artist,573,290,283,https://www.imdb.com/title/tt1655442/,https://raw.githubusercontent.com/eledah/imdb-delta/main/thumbnails/tt1655442.jpg,"Comedy, Drama, Romance"
493,Edge of Tomorrow,480,792,-312,https://www.imdb.com/title/tt1631867/,https://raw.githubusercontent.com/eledah/imdb-delta/main/thumbnails/tt1631867.jpg,"Action, Adventure, Sci-Fi"
496,Moon,538,576,-38,https://www.imdb.com/title/tt1182345/,https://raw.githubusercontent.com/eledah/imdb-delta/main/thumbnails/tt1182345.jpg,"Drama, Mystery, Sci-Fi"
497,Let the Right One In,521,746,-225,https://www.imdb.com/title/tt1139797/,https://raw.githubusercontent.com/eledah/imdb-delta/main/thumbnails/tt1139797.jpg,"Drama, Fantasy, Horror"
498,District 9,406,906,-500,https://www.imdb.com/title/tt1136608/,https://raw.githubusercontent.com/eledah/imdb-delta/main/thumbnails/tt1136608.jpg,"Action, Sci-Fi, Thriller"
499,The Wrestler,537,1049,-512,https://www.imdb.com/title/tt1125849/,https://raw.githubusercontent.com/eledah/imdb-delta/main/thumbnails/tt1125849.jpg,"Drama, Sport"
501,Boyhood,448,923,-475,https://www.imdb.com/title/tt1065073/,https://raw.githubusercontent.com/eledah/imdb-delta/main/thumbnails/tt1065073.jpg,Drama
503,Star Trek,474,236,238,https://www.imdb.com/title/tt0796366/,https://raw.githubusercontent.com/eledah/imdb-delta/main/thumbnails/tt0796366.jpg,"Action, Adventure, Sci-Fi"
504,In Bruges,496,760,-264,https://www.imdb.com/title/tt0780536/,https://raw.githubusercontent.com/eledah/imdb-delta/main/thumbnails/tt0780536.jpg,"Comedy, Crime, Drama"
505,The Man from Earth,428,1002,-574,https://www.imdb.com/title/tt0756683/,https://raw.githubusercontent.com/eledah/imdb-delta/main/thumbnails/tt0756683.jpg,"Drama, Fantasy, Mystery"
506,Letters from Iwo Jima,505,757,-252,https://www.imdb.com/title/tt0498380/,https://raw.githubusercontent.com/eledah/imdb-delta/main/thumbnails/tt0498380.jpg,"Action, Adventure, Drama"
507,The Fall,806,94,712,https://www.imdb.com/title/tt0460791/,https://raw.githubusercontent.com/eledah/imdb-delta/main/thumbnails/tt0460791.jpg,"Adventure, Drama, Fantasy"
508,Life of Pi,492,470,22,https://www.imdb.com/title/tt0454876/,https://raw.githubusercontent.com/eledah/imdb-delta/main/thumbnails/tt0454876.jpg,"Adventure, Drama, Fantasy"
509,Fantastic Mr. Fox,608,607,1,https://www.imdb.com/title/tt0432283/,https://raw.githubusercontent.com/eledah/imdb-delta/main/thumbnails/tt0432283.jpg,"Animation, Adventure, Comedy"
513,Iron Man,574,599,-25,https://www.imdb.com/title/tt0371746/,https://raw.githubusercontent.com/eledah/imdb-delta/main/thumbnails/tt0371746.jpg,"Action, Adventure, Sci-Fi"
514,Shaun of the Dead,517,541,-24,https://www.imdb.com/title/tt0365748/,https://raw.githubusercontent.com/eledah/imdb-delta/main/thumbnails/tt0365748.jpg,"Comedy, Horror"
517,Mystic River,493,513,-20,https://www.imdb.com/title/tt0327056/,https://raw.githubusercontent.com/eledah/imdb-delta/main/thumbnails/tt0327056.jpg,"Crime, Drama, Mystery"
518,Harry Potter and the Prisoner of Azkaban,723,165,558,https://www.imdb.com/title/tt0304141/,https://raw.githubusercontent.com/eledah/imdb-delta/main/thumbnails/tt0304141.jpg,"Adventure, Family, Fantasy"
519,Hero,525,425,100,https://www.imdb.com/title/tt0299977/,https://raw.githubusercontent.com/eledah/imdb-delta/main/thumbnails/tt0299977.jpg,"Action, Adventure, Drama"
520,Talk to Her,485,396,89,https://www.imdb.com/title/tt0287467/,https://raw.githubusercontent.com/eledah/imdb-delta/main/thumbnails/tt0287467.jpg,"Drama, Mystery, Romance"
523,The Bourne Identity,476,778,-302,https://www.imdb.com/title/tt0258463/,https://raw.githubusercontent.com/eledah/imdb-delta/main/thumbnails/tt0258463.jpg,"Action, Mystery, Thriller"
525,Children of Men,508,1004,-496,https://www.imdb.com/title/tt0206634/,https://raw.githubusercontent.com/eledah/imdb-delta/main/thumbnails/tt0206634.jpg,"Action, Drama, Sci-Fi"
526,Almost Famous,506,755,-249,https://www.imdb.com/title/tt0181875/,https://raw.githubusercontent.com/eledah/imdb-delta/main/thumbnails/tt0181875.jpg,"Adventure, Comedy, Drama"
527,Mulholland Dr.,470,818,-348,https://www.imdb.com/title/tt0166924/,https://raw.githubusercontent.com/eledah/imdb-delta/main/thumbnails/tt0166924.jpg,"Drama, Mystery, Thriller"
528,Toy Story 2,519,765,-246,https://www.imdb.com/title/tt0120363/,https://raw.githubusercontent.com/eledah/imdb-delta/main/thumbnails/tt0120363.jpg,"Animation, Adventure, Comedy"
529,Boogie Nights,511,1280,-769,https://www.imdb.com/title/tt0118749/,https://raw.githubusercontent.com/eledah/imdb-delta/main/thumbnails/tt0118749.jpg,Drama
532,True Romance,467,685,-218,https://www.imdb.com/title/tt0108399/,https://raw.githubusercontent.com/eledah/imdb-delta/main/thumbnails/tt0108399.jpg,"Crime, Drama, Romance"
535,Carlito's Way,533,947,-414,https://www.imdb.com/title/tt0106519/,https://raw.githubusercontent.com/eledah/imdb-delta/main/thumbnails/tt0106519.jpg,"Crime, Drama, Thriller"
536,Edward Scissorhands,681,202,479,https://www.imdb.com/title/tt0099487/,https://raw.githubusercontent.com/eledah/imdb-delta/main/thumbnails/tt0099487.jpg,"Drama, Fantasy, Romance"
539,The Untouchables,490,679,-189,https://www.imdb.com/title/tt0094226/,https://raw.githubusercontent.com/eledah/imdb-delta/main/thumbnails/tt0094226.jpg,"Crime, Drama, Thriller"
541,Brazil,527,558,-31,https://www.imdb.com/title/tt0088846/,https://raw.githubusercontent.com/eledah/imdb-delta/main/thumbnails/tt0088846.jpg,"Drama, Sci-Fi, Thriller"
542,This Is Spinal Tap,483,585,-102,https://www.imdb.com/title/tt0088258/,https://raw.githubusercontent.com/eledah/imdb-delta/main/thumbnails/tt0088258.jpg,"Comedy, Music"
543,A Christmas Story,455,366,89,https://www.imdb.com/title/tt0085334/,https://raw.githubusercontent.com/eledah/imdb-delta/main/thumbnails/tt0085334.jpg,"Comedy, Family"
544,The Blues Brothers,491,732,-241,https://www.imdb.com/title/tt0080455/,https://raw.githubusercontent.com/eledah/imdb-delta/main/thumbnails/tt0080455.jpg,"Action, Adventure, Comedy"
545,Manhattan,473,688,-215,https://www.imdb.com/title/tt0079522/,https://raw.githubusercontent.com/eledah/imdb-delta/main/thumbnails/tt0079522.jpg,"Comedy, Drama, Romance"
547,Dawn of the Dead,495,1226,-731,https://www.imdb.com/title/tt0077402/,https://raw.githubusercontent.com/eledah/imdb-delta/main/thumbnails/tt0077402.jpg,"Horror, Thriller"
548,All the President's Men,441,386,55,https://www.imdb.com/title/tt0074119/,https://raw.githubusercontent.com/eledah/imdb-delta/main/thumbnails/tt0074119.jpg,"Drama, History, Thriller"
556,Night of the Living Dead,523,859,-336,https://www.imdb.com/title/tt0063350/,https://raw.githubusercontent.com/eledah/imdb-delta/main/thumbnails/tt0063350.jpg,"Horror, Thriller"
561,Spartacus,462,866,-404,https://www.imdb.com/title/tt0054331/,https://raw.githubusercontent.com/eledah/imdb-delta/main/thumbnails/tt0054331.jpg,"Adventure, Biography, Drama"
568,Strangers on a Train,432,423,9,https://www.imdb.com/title/tt0044079/,https://raw.githubusercontent.com/eledah/imdb-delta/main/thumbnails/tt0044079.jpg,"Crime, Drama, Film-Noir"
581,The Gentlemen,705,674,31,https://www.imdb.com/title/tt8367814/,https://raw.githubusercontent.com/eledah/imdb-delta/main/thumbnails/tt8367814.jpg,"Action, Crime"
585,Dunkirk,588,561,27,https://www.imdb.com/title/tt5013056/,https://raw.githubusercontent.com/eledah/imdb-delta/main/thumbnails/tt5013056.jpg,"Action, Drama, History"
587,Hidden Figures,835,166,669,https://www.imdb.com/title/tt4846340/,https://raw.githubusercontent.com/eledah/imdb-delta/main/thumbnails/tt4846340.jpg,"Biography, Drama, History"
590,Kubo and the Two Strings,729,469,260,https://www.imdb.com/title/tt4302938/,https://raw.githubusercontent.com/eledah/imdb-delta/main/thumbnails/tt4302938.jpg,"Animation, Action, Adventure"
592,Manchester by the Sea,619,950,-331,https://www.imdb.com/title/tt4034228/,https://raw.githubusercontent.com/eledah/imdb-delta/main/thumbnails/tt4034228.jpg,Drama
594,Rogue One: A Star Wars Story,702,808,-106,https://www.imdb.com/title/tt3748528/,https://raw.githubusercontent.com/eledah/imdb-delta/main/thumbnails/tt3748528.jpg,"Action, Adventure, Sci-Fi"
595,Captain America: Civil War,677,695,-18,https://www.imdb.com/title/tt3498820/,https://raw.githubusercontent.com/eledah/imdb-delta/main/thumbnails/tt3498820.jpg,"Action, Sci-Fi"
596,The Hateful Eight,539,1247,-708,https://www.imdb.com/title/tt3460252/,https://raw.githubusercontent.com/eledah/imdb-delta/main/thumbnails/tt3460252.jpg,"Crime, Drama, Mystery"
597,Little Women,908,444,464,https://www.imdb.com/title/tt3281548/,https://raw.githubusercontent.com/eledah/imdb-delta/main/thumbnails/tt3281548.jpg,"Drama, Romance"
600,Nightcrawler,531,999,-468,https://www.imdb.com/title/tt2872718/,https://raw.githubusercontent.com/eledah/imdb-delta/main/thumbnails/tt2872718.jpg,"Crime, Drama, Thriller"
605,Big Hero 6,830,240,590,https://www.imdb.com/title/tt2245084/,https://raw.githubusercontent.com/eledah/imdb-delta/main/thumbnails/tt2245084.jpg,"Animation, Action, Adventure"
606,About Time,673,552,121,https://www.imdb.com/title/tt2194499/,https://raw.githubusercontent.com/eledah/imdb-delta/main/thumbnails/tt2194499.jpg,"Comedy, Drama, Fantasy"
609,Toy Story 4,770,775,-5,https://www.imdb.com/title/tt1979376/,https://raw.githubusercontent.com/eledah/imdb-delta/main/thumbnails/tt1979376.jpg,"Animation, Adventure, Comedy"
610,The Best Offer,692,548,144,https://www.imdb.com/title/tt1924396/,https://raw.githubusercontent.com/eledah/imdb-delta/main/thumbnails/tt1924396.jpg,"Crime, Drama, Mystery"
611,Moonrise Kingdom,695,596,99,https://www.imdb.com/title/tt1748122/,https://raw.githubusercontent.com/eledah/imdb-delta/main/thumbnails/tt1748122.jpg,"Adventure, Comedy, Drama"
612,How to Train Your Dragon 2,787,288,499,https://www.imdb.com/title/tt1646971/,https://raw.githubusercontent.com/eledah/imdb-delta/main/thumbnails/tt1646971.jpg,"Animation, Action, Adventure"
613,The Big Short,593,1033,-440,https://www.imdb.com/title/tt1596363/,https://raw.githubusercontent.com/eledah/imdb-delta/main/thumbnails/tt1596363.jpg,"Biography, Comedy, Drama"
615,I Saw the Devil,586,977,-391,https://www.imdb.com/title/tt1588170/,https://raw.githubusercontent.com/eledah/imdb-delta/main/thumbnails/tt1588170.jpg,"Action, Crime, Thriller"
616,The Girl with the Dragon Tattoo,589,382,207,https://www.imdb.com/title/tt1568346/,https://raw.githubusercontent.com/eledah/imdb-delta/main/thumbnails/tt1568346.jpg,"Crime, Drama, Mystery"
617,Captain Phillips,643,609,34,https://www.imdb.com/title/tt1535109/,https://raw.githubusercontent.com/eledah/imdb-delta/main/thumbnails/tt1535109.jpg,"Action, Biography, Crime"
619,Straight Outta Compton,650,566,84,https://www.imdb.com/title/tt1398426/,https://raw.githubusercontent.com/eledah/imdb-delta/main/thumbnails/tt1398426.jpg,"Biography, Drama, History"
620,The Irishman,548,1503,-955,https://www.imdb.com/title/tt1302006/,https://raw.githubusercontent.com/eledah/imdb-delta/main/thumbnails/tt1302006.jpg,"Biography, Crime, Drama"
623,The Hobbit: The Desolation of Smaug,687,358,329,https://www.imdb.com/title/tt1170358/,https://raw.githubusercontent.com/eledah/imdb-delta/main/thumbnails/tt1170358.jpg,"Adventure, Drama, Fantasy"
625,The Girl with the Dragon Tattoo,589,382,207,https://www.imdb.com/title/tt1132620/,https://raw.githubusercontent.com/eledah/imdb-delta/main/thumbnails/tt1132620.jpg,"Crime, Drama, Mystery"
626,Skyfall,715,896,-181,https://www.imdb.com/title/tt1074638/,https://raw.githubusercontent.com/eledah/imdb-delta/main/thumbnails/tt1074638.jpg,"Action, Adventure, Thriller"
627,The Trial of the Chicago 7,733,453,280,https://www.imdb.com/title/tt1070874/,https://raw.githubusercontent.com/eledah/imdb-delta/main/thumbnails/tt1070874.jpg,"Drama, History, Thriller"
629,The Fighter,598,802,-204,https://www.imdb.com/title/tt0964517/,https://raw.githubusercontent.com/eledah/imdb-delta/main/thumbnails/tt0964517.jpg,"Action, Biography, Drama"
630,Taken,652,837,-185,https://www.imdb.com/title/tt0936501/,https://raw.githubusercontent.com/eledah/imdb-delta/main/thumbnails/tt0936501.jpg,"Action, Crime, Thriller"
631,The Boy in the Striped Pajamas,885,226,659,https://www.imdb.com/title/tt0914798/,https://raw.githubusercontent.com/eledah/imdb-delta/main/thumbnails/tt0914798.jpg,"Drama, War"
632,Once,546,900,-354,https://www.imdb.com/title/tt0907657/,https://raw.githubusercontent.com/eledah/imdb-delta/main/thumbnails/tt0907657.jpg,"Drama, Music, Romance"
633,The Hobbit: An Unexpected Journey,606,306,300,https://www.imdb.com/title/tt0903624/,https://raw.githubusercontent.com/eledah/imdb-delta/main/thumbnails/tt0903624.jpg,"Adventure, Fantasy"
635,Atonement,784,504,280,https://www.imdb.com/title/tt0783233/,https://raw.githubusercontent.com/eledah/imdb-delta/main/thumbnails/tt0783233.jpg,"Drama, Mystery, Romance"
636,Drive,597,1238,-641,https://www.imdb.com/title/tt0780504/,https://raw.githubusercontent.com/eledah/imdb-delta/main/thumbnails/tt0780504.jpg,"Action, Drama"
637,American Gangster,605,1024,-419,https://www.imdb.com/title/tt0765429/,https://raw.githubusercontent.com/eledah/imdb-delta/main/thumbnails/tt0765429.jpg,"Biography, Crime, Drama"
638,Avatar,552,899,-347,https://www.imdb.com/title/tt0499549/,https://raw.githubusercontent.com/eledah/imdb-delta/main/thumbnails/tt0499549.jpg,"Action, Adventure, Fantasy"
639,Mr. Nobody,631,515,116,https://www.imdb.com/title/tt0485947/,https://raw.githubusercontent.com/eledah/imdb-delta/main/thumbnails/tt0485947.jpg,"Drama, Fantasy, Romance"
640,Apocalypto,616,615,1,https://www.imdb.com/title/tt0472043/,https://raw.githubusercontent.com/eledah/imdb-delta/main/thumbnails/tt0472043.jpg,"Action, Adventure, Drama"
641,Little Miss Sunshine,656,438,218,https://www.imdb.com/title/tt0449059/,https://raw.githubusercontent.com/eledah/imdb-delta/main/thumbnails/tt0449059.jpg,"Comedy, Drama"
642,Hot Fuzz,604,628,-24,https://www.imdb.com/title/tt0425112/,https://raw.githubusercontent.com/eledah/imdb-delta/main/thumbnails/tt0425112.jpg,"Action, Comedy, Mystery"
643,The Curious Case of Benjamin Button,599,704,-105,https://www.imdb.com/title/tt0421715/,https://raw.githubusercontent.com/eledah/imdb-delta/main/thumbnails/tt0421715.jpg,"Drama, Fantasy, Romance"
646,Pride & Prejudice,1223,213,1010,https://www.imdb.com/title/tt0414387/,https://raw.githubusercontent.com/eledah/imdb-delta/main/thumbnails/tt0414387.jpg,"Drama, Romance"
648,Serenity,617,235,382,https://www.imdb.com/title/tt0379786/,https://raw.githubusercontent.com/eledah/imdb-delta/main/thumbnails/tt0379786.jpg,"Action, Adventure, Sci-Fi"
649,Walk the Line,620,398,222,https://www.imdb.com/title/tt0358273/,https://raw.githubusercontent.com/eledah/imdb-delta/main/thumbnails/tt0358273.jpg,"Biography, Drama, Music"
651,The Notebook,841,216,625,https://www.imdb.com/title/tt0332280/,https://raw.githubusercontent.com/eledah/imdb-delta/main/thumbnails/tt0332280.jpg,"Drama, Romance"
656,The Count of Monte Cristo,793,611,182,https://www.imdb.com/title/tt0245844/,https://raw.githubusercontent.com/eledah/imdb-delta/main/thumbnails/tt0245844.jpg,"Action, Adventure, Drama"
658,Remember the Titans,764,456,308,https://www.imdb.com/title/tt0210945/,https://raw.githubusercontent.com/eledah/imdb-delta/main/thumbnails/tt0210945.jpg,"Biography, Comedy, Drama"
659,"Crouching Tiger, Hidden Dragon",584,600,-16,https://www.imdb.com/title/tt0190332/,https://raw.githubusercontent.com/eledah/imdb-delta/main/thumbnails/tt0190332.jpg,"Action, Adventure, Drama"
661,Cast Away,610,915,-305,https://www.imdb.com/title/tt0162222/,https://raw.githubusercontent.com/eledah/imdb-delta/main/thumbnails/tt0162222.jpg,"Adventure, Drama, Romance"
662,The Boondock Saints,716,319,397,https://www.imdb.com/title/tt0144117/,https://raw.githubusercontent.com/eledah/imdb-delta/main/thumbnails/tt0144117.jpg,"Action, Crime, Thriller"
663,The Insider,630,946,-316,https://www.imdb.com/title/tt0140352/,https://raw.githubusercontent.com/eledah/imdb-delta/main/thumbnails/tt0140352.jpg,"Biography, Drama, History"
665,Shrek,564,445,119,https://www.imdb.com/title/tt0126029/,https://raw.githubusercontent.com/eledah/imdb-delta/main/thumbnails/tt0126029.jpg,"Animation, Adventure, Comedy"
666,Titanic,820,289,531,https://www.imdb.com/title/tt0120338/,https://raw.githubusercontent.com/eledah/imdb-delta/main/thumbnails/tt0120338.jpg,"Drama, Romance"
668,Gattaca,672,742,-70,https://www.imdb.com/title/tt0119177/,https://raw.githubusercontent.com/eledah/imdb-delta/main/thumbnails/tt0119177.jpg,"Drama, Sci-Fi, Thriller"
669,The Game,661,935,-274,https://www.imdb.com/title/tt0119174/,https://raw.githubusercontent.com/eledah/imdb-delta/main/thumbnails/tt0119174.jpg,"Drama, Mystery, Thriller"
671,Ed Wood,609,1015,-406,https://www.imdb.com/title/tt0109707/,https://raw.githubusercontent.com/eledah/imdb-delta/main/thumbnails/tt0109707.jpg,"Biography, Comedy, Drama"
672,What's Eating Gilbert Grape,872,462,410,https://www.imdb.com/title/tt0108550/,https://raw.githubusercontent.com/eledah/imdb-delta/main/thumbnails/tt0108550.jpg,Drama
673,Tombstone,628,435,193,https://www.imdb.com/title/tt0108358/,https://raw.githubusercontent.com/eledah/imdb-delta/main/thumbnails/tt0108358.jpg,"Biography, Drama, History"
677,The Fugitive,615,897,-282,https://www.imdb.com/title/tt0106977/,https://raw.githubusercontent.com/eledah/imdb-delta/main/thumbnails/tt0106977.jpg,"Action, Crime, Drama"
678,A Bronx Tale,732,667,65,https://www.imdb.com/title/tt0106489/,https://raw.githubusercontent.com/eledah/imdb-delta/main/thumbnails/tt0106489.jpg,"Crime, Drama"
683,Boyz n the Hood,768,835,-67,https://www.imdb.com/title/tt0101507/,https://raw.githubusercontent.com/eledah/imdb-delta/main/thumbnails/tt0101507.jpg,"Crime, Drama"
684,Misery,621,528,93,https://www.imdb.com/title/tt0100157/,https://raw.githubusercontent.com/eledah/imdb-delta/main/thumbnails/tt0100157.jpg,"Drama, Thriller"
685,Awakenings,641,406,235,https://www.imdb.com/title/tt0099077/,https://raw.githubusercontent.com/eledah/imdb-delta/main/thumbnails/tt0099077.jpg,"Biography, Drama"
686,Kiki's Delivery Service,662,455,207,https://www.imdb.com/title/tt0097814/,https://raw.githubusercontent.com/eledah/imdb-delta/main/thumbnails/tt0097814.jpg,"Animation, Family, Fantasy"
687,Glory,596,542,54,https://www.imdb.com/title/tt0097441/,https://raw.githubusercontent.com/eledah/imdb-delta/main/thumbnails/tt0097441.jpg,"Biography, Drama, History"
689,Back to the Future Part II,566,787,-221,https://www.imdb.com/title/tt0096874/,https://raw.githubusercontent.com/eledah/imdb-delta/main/thumbnails/tt0096874.jpg,"Adventure, Comedy, Sci-Fi"
691,Predator,551,1657,-1106,https://www.imdb.com/title/tt0093773/,https://raw.githubusercontent.com/eledah/imdb-delta/main/thumbnails/tt0093773.jpg,"Action, Adventure, Horror"
692,Evil Dead II,646,1463,-817,https://www.imdb.com/title/tt0092991/,https://raw.githubusercontent.com/eledah/imdb-delta/main/thumbnails/tt0092991.jpg,"Comedy, Horror"
693,Ferris Bueller's Day Off,667,658,9,https://www.imdb.com/title/tt0091042/,https://raw.githubusercontent.com/eledah/imdb-delta/main/thumbnails/tt0091042.jpg,Comedy
695,The Goonies,769,392,377,https://www.imdb.com/title/tt0089218/,https://raw.githubusercontent.com/eledah/imdb-delta/main/thumbnails/tt0089218.jpg,"Adventure, Comedy, Family"
697,The Breakfast Club,657,391,266,https://www.imdb.com/title/tt0088847/,https://raw.githubusercontent.com/eledah/imdb-delta/main/thumbnails/tt0088847.jpg,"Comedy, Drama"
699,Ghostbusters,691,1076,-385,https://www.imdb.com/title/tt0087332/,https://raw.githubusercontent.com/eledah/imdb-delta/main/thumbnails/tt0087332.jpg,"Action, Comedy, Fantasy"
702,E.T. the Extra-Terrestrial,559,520,39,https://www.imdb.com/title/tt0083866/,https://raw.githubusercontent.com/eledah/imdb-delta/main/thumbnails/tt0083866.jpg,"Adventure, Family, Sci-Fi"
703,Kramer vs. Kramer,674,692,-18,https://www.imdb.com/title/tt0079417/,https://raw.githubusercontent.com/eledah/imdb-delta/main/thumbnails/tt0079417.jpg,Drama
707,The Conversation,570,879,-309,https://www.imdb.com/title/tt0071360/,https://raw.githubusercontent.com/eledah/imdb-delta/main/thumbnails/tt0071360.jpg,"Drama, Mystery, Thriller"
712,Willy Wonka & the Chocolate Factory,648,549,99,https://www.imdb.com/title/tt0067992/,https://raw.githubusercontent.com/eledah/imdb-delta/main/thumbnails/tt0067992.jpg,"Adventure, Comedy, Family"
713,Midnight Cowboy,557,805,-248,https://www.imdb.com/title/tt0064665/,https://raw.githubusercontent.com/eledah/imdb-delta/main/thumbnails/tt0064665.jpg,Drama
716,Bonnie and Clyde,701,831,-130,https://www.imdb.com/title/tt0061418/,https://raw.githubusercontent.com/eledah/imdb-delta/main/thumbnails/tt0061418.jpg,"Action, Biography, Crime"
718,Mary Poppins,857,298,559,https://www.imdb.com/title/tt0058331/,https://raw.githubusercontent.com/eledah/imdb-delta/main/thumbnails/tt0058331.jpg,"Comedy, Family, Fantasy"
736,Roma,822,952,-130,https://www.imdb.com/title/tt6155172/,https://raw.githubusercontent.com/eledah/imdb-delta/main/thumbnails/tt6155172.jpg,Drama
738,Deadpool 2,852,797,55,https://www.imdb.com/title/tt5463162/,https://raw.githubusercontent.com/eledah/imdb-delta/main/thumbnails/tt5463162.jpg,"Action, Adventure, Comedy"
739,Wind River,816,945,-129,https://www.imdb.com/title/tt5362988/,https://raw.githubusercontent.com/eledah/imdb-delta/main/thumbnails/tt5362988.jpg,"Crime, Drama, Mystery"
740,Get Out,825,832,-7,https://www.imdb.com/title/tt5052448/,https://raw.githubusercontent.com/eledah/imdb-delta/main/thumbnails/tt5052448.jpg,"Horror, Mystery, Thriller"
741,Mission: Impossible - Fallout,756,1285,-529,https://www.imdb.com/title/tt4912910/,https://raw.githubusercontent.com/eledah/imdb-delta/main/thumbnails/tt4912910.jpg,"Action, Adventure, Thriller"
744,What We Do in the Shadows,890,476,414,https://www.imdb.com/title/tt3416742/,https://raw.githubusercontent.com/eledah/imdb-delta/main/thumbnails/tt3416742.jpg,"Comedy, Horror"
746,The Theory of Everything,936,478,458,https://www.imdb.com/title/tt2980516/,https://raw.githubusercontent.com/eledah/imdb-delta/main/thumbnails/tt2980516.jpg,"Biography, Drama, Romance"
747,Kingsman: The Secret Service,805,666,139,https://www.imdb.com/title/tt2802144/,https://raw.githubusercontent.com/eledah/imdb-delta/main/thumbnails/tt2802144.jpg,"Action, Adventure, Comedy"
748,The Fault in Our Stars,884,669,215,https://www.imdb.com/title/tt2582846/,https://raw.githubusercontent.com/eledah/imdb-delta/main/thumbnails/tt2582846.jpg,"Drama, Romance"
749,Me and Earl and the Dying Girl,727,788,-61,https://www.imdb.com/title/tt2582496/,https://raw.githubusercontent.com/eledah/imdb-delta/main/thumbnails/tt2582496.jpg,"Comedy, Drama"
750,Birdman or (The Unexpected Virtue of Ignorance),645,1336,-691,https://www.imdb.com/title/tt2562232/,https://raw.githubusercontent.com/eledah/imdb-delta/main/thumbnails/tt2562232.jpg,"Comedy, Drama"
751,Blue Is the Warmest Colour,734,904,-170,https://www.imdb.com/title/tt2278871/,https://raw.githubusercontent.com/eledah/imdb-delta/main/thumbnails/tt2278871.jpg,"Drama, Romance"
754,Captain America: The Winter Soldier,780,618,162,https://www.imdb.com/title/tt1843866/,https://raw.githubusercontent.com/eledah/imdb-delta/main/thumbnails/tt1843866.jpg,"Action, Adventure, Sci-Fi"
756,Nebraska,703,790,-87,https://www.imdb.com/title/tt1821549/,https://raw.githubusercontent.com/eledah/imdb-delta/main/thumbnails/tt1821549.jpg,Drama
757,Wreck-It Ralph,788,823,-35,https://www.imdb.com/title/tt1772341/,https://raw.githubusercontent.com/eledah/imdb-delta/main/thumbnails/tt1772341.jpg,"Animation, Adventure, Comedy"
760,Midnight in Paris,845,1106,-261,https://www.imdb.com/title/tt1605783/,https://raw.githubusercontent.com/eledah/imdb-delta/main/thumbnails/tt1605783.jpg,"Comedy, Fantasy, Romance"
761,The Lego Movie,666,995,-329,https://www.imdb.com/title/tt1490017/,https://raw.githubusercontent.com/eledah/imdb-delta/main/thumbnails/tt1490017.jpg,"Animation, Action, Adventure"
762,Gravity,676,1366,-690,https://www.imdb.com/title/tt1454468/,https://raw.githubusercontent.com/eledah/imdb-delta/main/thumbnails/tt1454468.jpg,"Drama, Sci-Fi, Thriller"
763,Star Trek Into Darkness,866,429,437,https://www.imdb.com/title/tt1408101/,https://raw.githubusercontent.com/eledah/imdb-delta/main/thumbnails/tt1408101.jpg,"Action, Adventure, Sci-Fi"
765,The Social Network,663,1497,-834,https://www.imdb.com/title/tt1285016/,https://raw.githubusercontent.com/eledah/imdb-delta/main/thumbnails/tt1285016.jpg,"Biography, Drama"
766,X-Men: First Class,754,579,175,https://www.imdb.com/title/tt1270798/,https://raw.githubusercontent.com/eledah/imdb-delta/main/thumbnails/tt1270798.jpg,"Action, Sci-Fi"
767,The Hangover,678,1242,-564,https://www.imdb.com/title/tt1119646/,https://raw.githubusercontent.com/eledah/imdb-delta/main/thumbnails/tt1119646.jpg,Comedy
768,Silver Linings Playbook,699,980,-281,https://www.imdb.com/title/tt1045658/,https://raw.githubusercontent.com/eledah/imdb-delta/main/thumbnails/tt1045658.jpg,"Comedy, Drama, Romance"
769,Argo,859,653,206,https://www.imdb.com/title/tt1024648/,https://raw.githubusercontent.com/eledah/imdb-delta/main/thumbnails/tt1024648.jpg,"Biography, Drama, History"
770,500 Days of Summer,747,1222,-475,https://www.imdb.com/title/tt1022603/,https://raw.githubusercontent.com/eledah/imdb-delta/main/thumbnails/tt1022603.jpg,"Comedy, Drama, Romance"
771,Harry Potter and the Deathly Hallows: Part 1,1146,187,959,https://www.imdb.com/title/tt0926084/,https://raw.githubusercontent.com/eledah/imdb-delta/main/thumbnails/tt0926084.jpg,"Adventure, Family, Fantasy"
772,Ponyo,937,690,247,https://www.imdb.com/title/tt0876563/,https://raw.githubusercontent.com/eledah/imdb-delta/main/thumbnails/tt0876563.jpg,"Animation, Adventure, Comedy"
773,Frost/Nixon,821,873,-52,https://www.imdb.com/title/tt0870111/,https://raw.githubusercontent.com/eledah/imdb-delta/main/thumbnails/tt0870111.jpg,"Biography, Drama, History"
775,Changeling,752,756,-4,https://www.imdb.com/title/tt0824747/,https://raw.githubusercontent.com/eledah/imdb-delta/main/thumbnails/tt0824747.jpg,"Biography, Crime, Drama"
779,This Is England,896,834,62,https://www.imdb.com/title/tt0480025/,https://raw.githubusercontent.com/eledah/imdb-delta/main/thumbnails/tt0480025.jpg,"Crime, Drama"
780,Ex Machina,711,1132,-421,https://www.imdb.com/title/tt0470752/,https://raw.githubusercontent.com/eledah/imdb-delta/main/thumbnails/tt0470752.jpg,"Drama, Sci-Fi, Thriller"
782,The Last King of Scotland,808,686,122,https://www.imdb.com/title/tt0455590/,https://raw.githubusercontent.com/eledah/imdb-delta/main/thumbnails/tt0455590.jpg,"Biography, Drama, History"
783,Zodiac,832,1343,-511,https://www.imdb.com/title/tt0443706/,https://raw.githubusercontent.com/eledah/imdb-delta/main/thumbnails/tt0443706.jpg,"Crime, Drama, Mystery"
784,Lucky Number Slevin,792,683,109,https://www.imdb.com/title/tt0425210/,https://raw.githubusercontent.com/eledah/imdb-delta/main/thumbnails/tt0425210.jpg,"Crime, Drama, Thriller"
787,Tangled,960,297,663,https://www.imdb.com/title/tt0398286/,https://raw.githubusercontent.com/eledah/imdb-delta/main/thumbnails/tt0398286.jpg,"Animation, Adventure, Comedy"
789,Brokeback Mountain,1071,553,518,https://www.imdb.com/title/tt0388795/,https://raw.githubusercontent.com/eledah/imdb-delta/main/thumbnails/tt0388795.jpg,"Drama, Romance"
790,3:10 to Yuma,803,842,-39,https://www.imdb.com/title/tt0381849/,https://raw.githubusercontent.com/eledah/imdb-delta/main/thumbnails/tt0381849.jpg,"Action, Crime, Drama"
791,Crash,679,721,-42,https://www.imdb.com/title/tt0375679/,https://raw.githubusercontent.com/eledah/imdb-delta/main/thumbnails/tt0375679.jpg,"Crime, Drama, Thriller"
792,Kung Fu Hustle,725,745,-20,https://www.imdb.com/title/tt0373074/,https://raw.githubusercontent.com/eledah/imdb-delta/main/thumbnails/tt0373074.jpg,"Action, Comedy, Fantasy"
793,The Bourne Supremacy,744,953,-209,https://www.imdb.com/title/tt0372183/,https://raw.githubusercontent.com/eledah/imdb-delta/main/thumbnails/tt0372183.jpg,"Action, Mystery, Thriller"
794,The Machinist,814,841,-27,https://www.imdb.com/title/tt0361862/,https://raw.githubusercontent.com/eledah/imdb-delta/main/thumbnails/tt0361862.jpg,"Drama, Thriller"
795,Ray,785,801,-16,https://www.imdb.com/title/tt0350258/,https://raw.githubusercontent.com/eledah/imdb-delta/main/thumbnails/tt0350258.jpg,"Biography, Drama, Music"
796,Lost in Translation,664,1462,-798,https://www.imdb.com/title/tt0335266/,https://raw.githubusercontent.com/eledah/imdb-delta/main/thumbnails/tt0335266.jpg,"Comedy, Drama"
797,Harry Potter and the Goblet of Fire,1130,361,769,https://www.imdb.com/title/tt0330373/,https://raw.githubusercontent.com/eledah/imdb-delta/main/thumbnails/tt0330373.jpg,"Adventure, Family, Fantasy"
798,Man on Fire,828,804,24,https://www.imdb.com/title/tt0328107/,https://raw.githubusercontent.com/eledah/imdb-delta/main/thumbnails/tt0328107.jpg,"Action, Crime, Drama"
799,Coraline,883,747,136,https://www.imdb.com/title/tt0327597/,https://raw.githubusercontent.com/eledah/imdb-delta/main/thumbnails/tt0327597.jpg,"Animation, Drama, Family"
800,The Last Samurai,728,1289,-561,https://www.imdb.com/title/tt0325710/,https://raw.githubusercontent.com/eledah/imdb-delta/main/thumbnails/tt0325710.jpg,"Action, Drama"
802,Good Bye Lenin!,807,551,256,https://www.imdb.com/title/tt0301357/,https://raw.githubusercontent.com/eledah/imdb-delta/main/thumbnails/tt0301357.jpg,"Comedy, Drama, Romance"
804,I Am Sam,1116,488,628,https://www.imdb.com/title/tt0277027/,https://raw.githubusercontent.com/eledah/imdb-delta/main/thumbnails/tt0277027.jpg,Drama
805,Adaptation.,817,1626,-809,https://www.imdb.com/title/tt0268126/,https://raw.githubusercontent.com/eledah/imdb-delta/main/thumbnails/tt0268126.jpg,"Comedy, Drama"
806,Black Hawk Down,748,1330,-582,https://www.imdb.com/title/tt0265086/,https://raw.githubusercontent.com/eledah/imdb-delta/main/thumbnails/tt0265086.jpg,"Action, Drama, History"
807,Road to Perdition,815,1205,-390,https://www.imdb.com/title/tt0257044/,https://raw.githubusercontent.com/eledah/imdb-delta/main/thumbnails/tt0257044.jpg,"Crime, Drama, Thriller"
809,Billy Elliot,1028,375,653,https://www.imdb.com/title/tt0249462/,https://raw.githubusercontent.com/eledah/imdb-delta/main/thumbnails/tt0249462.jpg,"Drama, Music"
811,Ocean's Eleven,649,852,-203,https://www.imdb.com/title/tt0240772/,https://raw.githubusercontent.com/eledah/imdb-delta/main/thumbnails/tt0240772.jpg,"Crime, Thriller"
813,"O Brother, Where Art Thou?",774,829,-55,https://www.imdb.com/title/tt0190590/,https://raw.githubusercontent.com/eledah/imdb-delta/main/thumbnails/tt0190590.jpg,"Comedy, Crime, Drama"
815,"South Park: Bigger, Longer & Uncut",680,1516,-836,https://www.imdb.com/title/tt0158983/,https://raw.githubusercontent.com/eledah/imdb-delta/main/thumbnails/tt0158983.jpg,"Animation, Comedy, Fantasy"
816,Office Space,721,1263,-542,https://www.imdb.com/title/tt0151804/,https://raw.githubusercontent.com/eledah/imdb-delta/main/thumbnails/tt0151804.jpg,Comedy
818,Training Day,651,1436,-785,https://www.imdb.com/title/tt0139654/,https://raw.githubusercontent.com/eledah/imdb-delta/main/thumbnails/tt0139654.jpg,"Crime, Drama, Thriller"
819,Rushmore,836,1282,-446,https://www.imdb.com/title/tt0128445/,https://raw.githubusercontent.com/eledah/imdb-delta/main/thumbnails/tt0128445.jpg,"Comedy, Drama, Romance"
821,Being John Malkovich,790,1097,-307,https://www.imdb.com/title/tt0120601/,https://raw.githubusercontent.com/eledah/imdb-delta/main/thumbnails/tt0120601.jpg,"Comedy, Drama, Fantasy"
822,As Good as It Gets,777,974,-197,https://www.imdb.com/title/tt0119822/,https://raw.githubusercontent.com/eledah/imdb-delta/main/thumbnails/tt0119822.jpg,"Comedy, Drama, Romance"
823,The Fifth Element,843,575,268,https://www.imdb.com/title/tt0119116/,https://raw.githubusercontent.com/eledah/imdb-delta/main/thumbnails/tt0119116.jpg,"Action, Adventure, Sci-Fi"
825,Donnie Brasco,660,1016,-356,https://www.imdb.com/title/tt0119008/,https://raw.githubusercontent.com/eledah/imdb-delta/main/thumbnails/tt0119008.jpg,"Biography, Crime, Drama"
827,Primal Fear,899,597,302,https://www.imdb.com/title/tt0117381/,https://raw.githubusercontent.com/eledah/imdb-delta/main/thumbnails/tt0117381.jpg,"Crime, Drama, Mystery"
832,Clerks,669,1283,-614,https://www.imdb.com/title/tt0109445/,https://raw.githubusercontent.com/eledah/imdb-delta/main/thumbnails/tt0109445.jpg,Comedy
834,Philadelphia,844,401,443,https://www.imdb.com/title/tt0107818/,https://raw.githubusercontent.com/eledah/imdb-delta/main/thumbnails/tt0107818.jpg,Drama
838,The Last of the Mohicans,791,776,15,https://www.imdb.com/title/tt0104691/,https://raw.githubusercontent.com/eledah/imdb-delta/main/thumbnails/tt0104691.jpg,"Action, Adventure, Drama"
841,A Few Good Men,888,957,-69,https://www.imdb.com/title/tt0104257/,https://raw.githubusercontent.com/eledah/imdb-delta/main/thumbnails/tt0104257.jpg,"Drama, Thriller"
843,Barton Fink,802,1288,-486,https://www.imdb.com/title/tt0101410/,https://raw.githubusercontent.com/eledah/imdb-delta/main/thumbnails/tt0101410.jpg,"Comedy, Drama, Thriller"
844,Miller's Crossing,634,1191,-557,https://www.imdb.com/title/tt0100150/,https://raw.githubusercontent.com/eledah/imdb-delta/main/thumbnails/tt0100150.jpg,"Crime, Drama, Thriller"
845,Who Framed Roger Rabbit,846,1043,-197,https://www.imdb.com/title/tt0096438/,https://raw.githubusercontent.com/eledah/imdb-delta/main/thumbnails/tt0096438.jpg,"Animation, Adventure, Comedy"
849,Empire of the Sun,798,402,396,https://www.imdb.com/title/tt0092965/,https://raw.githubusercontent.com/eledah/imdb-delta/main/thumbnails/tt0092965.jpg,"Drama, War"
850,The Name of the Rose,700,1010,-310,https://www.imdb.com/title/tt0091605/,https://raw.githubusercontent.com/eledah/imdb-delta/main/thumbnails/tt0091605.jpg,"Drama, Mystery, Thriller"
851,Blue Velvet,720,1414,-694,https://www.imdb.com/title/tt0090756/,https://raw.githubusercontent.com/eledah/imdb-delta/main/thumbnails/tt0090756.jpg,"Crime, Drama, Mystery"
856,Star Trek II: The Wrath of Khan,799,1052,-253,https://www.imdb.com/title/tt0084726/,https://raw.githubusercontent.com/eledah/imdb-delta/main/thumbnails/tt0084726.jpg,"Action, Adventure, Sci-Fi"
857,First Blood,775,1842,-1067,https://www.imdb.com/title/tt0083944/,https://raw.githubusercontent.com/eledah/imdb-delta/main/thumbnails/tt0083944.jpg,"Action, Adventure, Thriller"
859,Airplane!,659,1377,-718,https://www.imdb.com/title/tt0080339/,https://raw.githubusercontent.com/eledah/imdb-delta/main/thumbnails/tt0080339.jpg,Comedy
861,Halloween,710,1216,-506,https://www.imdb.com/title/tt0077651/,https://raw.githubusercontent.com/eledah/imdb-delta/main/thumbnails/tt0077651.jpg,"Horror, Thriller"
865,Blazing Saddles,760,782,-22,https://www.imdb.com/title/tt0071230/,https://raw.githubusercontent.com/eledah/imdb-delta/main/thumbnails/tt0071230.jpg,"Comedy, Western"
866,Serpico,750,819,-69,https://www.imdb.com/title/tt0070666/,https://raw.githubusercontent.com/eledah/imdb-delta/main/thumbnails/tt0070666.jpg,"Biography, Crime, Drama"
869,The French Connection,749,1482,-733,https://www.imdb.com/title/tt0067116/,https://raw.githubusercontent.com/eledah/imdb-delta/main/thumbnails/tt0067116.jpg,"Action, Crime, Drama"
870,Dirty Harry,658,1270,-612,https://www.imdb.com/title/tt0066999/,https://raw.githubusercontent.com/eledah/imdb-delta/main/thumbnails/tt0066999.jpg,"Action, Crime, Thriller"
878,Goldfinger,707,1643,-936,https://www.imdb.com/title/tt0058150/,https://raw.githubusercontent.com/eledah/imdb-delta/main/thumbnails/tt0058150.jpg,"Action, Adventure, Thriller"
879,The Birds,842,845,-3,https://www.imdb.com/title/tt0056869/,https://raw.githubusercontent.com/eledah/imdb-delta/main/thumbnails/tt0056869.jpg,"Drama, Horror, Mystery"
898,The Two Popes,1097,919,178,https://www.imdb.com/title/tt8404614/,https://raw.githubusercontent.com/eledah/imdb-delta/main/thumbnails/tt8404614.jpg,"Biography, Comedy, Drama"
900,Searching,1003,930,73,https://www.imdb.com/title/tt7668870/,https://raw.githubusercontent.com/eledah/imdb-delta/main/thumbnails/tt7668870.jpg,"Drama, Mystery, Thriller"
903,Once Upon a Time... In Hollywood,919,1475,-556,https://www.imdb.com/title/tt7131622/,https://raw.githubusercontent.com/eledah/imdb-delta/main/thumbnails/tt7131622.jpg,"Comedy, Drama"
908,Train to Busan,1158,691,467,https://www.imdb.com/title/tt5700672/,https://raw.githubusercontent.com/eledah/imdb-delta/main/thumbnails/tt5700672.jpg,"Action, Horror, Thriller"
911,"Love, Simon",1289,860,429,https://www.imdb.com/title/tt5164432/,https://raw.githubusercontent.com/eledah/imdb-delta/main/thumbnails/tt5164432.jpg,"Comedy, Drama"
913,Gifted,1018,815,203,https://www.imdb.com/title/tt4481414/,https://raw.githubusercontent.com/eledah/imdb-delta/main/thumbnails/tt4481414.jpg,Drama
917,Guardians of the Galaxy Vol. 2,1068,660,408,https://www.imdb.com/title/tt3896198/,https://raw.githubusercontent.com/eledah/imdb-delta/main/thumbnails/tt3896198.jpg,"Action, Adventure, Comedy"
918,Baby Driver,1080,1227,-147,https://www.imdb.com/title/tt3890160/,https://raw.githubusercontent.com/eledah/imdb-delta/main/thumbnails/tt3890160.jpg,"Action, Crime, Drama"
921,Bridge of Spies,995,1138,-143,https://www.imdb.com/title/tt3682448/,https://raw.githubusercontent.com/eledah/imdb-delta/main/thumbnails/tt3682448.jpg,"Drama, History, Thriller"
922,Incredibles 2,981,743,238,https://www.imdb.com/title/tt3606756/,https://raw.githubusercontent.com/eledah/imdb-delta/main/thumbnails/tt3606756.jpg,"Animation, Action, Adventure"
923,Moana,1163,517,646,https://www.imdb.com/title/tt3521164/,https://raw.githubusercontent.com/eledah/imdb-delta/main/thumbnails/tt3521164.jpg,"Animation, Adventure, Comedy"
924,Sicario,855,1711,-856,https://www.imdb.com/title/tt3397884/,https://raw.githubusercontent.com/eledah/imdb-delta/main/thumbnails/tt3397884.jpg,"Action, Crime, Drama"
925,Creed,1008,1265,-257,https://www.imdb.com/title/tt3076658/,https://raw.githubusercontent.com/eledah/imdb-delta/main/thumbnails/tt3076658.jpg,"Action, Drama, Sport"
928,Fury,972,1268,-296,https://www.imdb.com/title/tt2713180/,https://raw.githubusercontent.com/eledah/imdb-delta/main/thumbnails/tt2713180.jpg,"Action, Drama, War"
929,Hell or High Water,858,1486,-628,https://www.imdb.com/title/tt2582782/,https://raw.githubusercontent.com/eledah/imdb-delta/main/thumbnails/tt2582782.jpg,"Crime, Drama, Thriller"
933,Dawn of the Planet of the Apes,989,1318,-329,https://www.imdb.com/title/tt2103281/,https://raw.githubusercontent.com/eledah/imdb-delta/main/thumbnails/tt2103281.jpg,"Action, Adventure, Drama"
936,The Raid: Redemption,913,1438,-525,https://www.imdb.com/title/tt1899353/,https://raw.githubusercontent.com/eledah/imdb-delta/main/thumbnails/tt1899353.jpg,"Action, Crime, Thriller"
937,End of Watch,904,1123,-219,https://www.imdb.com/title/tt1855199/,https://raw.githubusercontent.com/eledah/imdb-delta/main/thumbnails/tt1855199.jpg,"Action, Crime, Drama"
939,Les Misérables,1236,635,601,https://www.imdb.com/title/tt1707386/,https://raw.githubusercontent.com/eledah/imdb-delta/main/thumbnails/tt1707386.jpg,"Drama, Musical, Romance"
940,The Impossible,1234,532,702,https://www.imdb.com/title/tt1649419/,https://raw.githubusercontent.com/eledah/imdb-delta/main/thumbnails/tt1649419.jpg,"Drama, History, Thriller"
942,A Star Is Born,950,867,83,https://www.imdb.com/title/tt1517451/,https://raw.githubusercontent.com/eledah/imdb-delta/main/thumbnails/tt1517451.jpg,"Drama, Music, Romance"
943,The Greatest Showman,1329,568,761,https://www.imdb.com/title/tt1485796/,https://raw.githubusercontent.com/eledah/imdb-delta/main/thumbnails/tt1485796.jpg,"Biography, Drama, Musical"
947,True Grit,903,1244,-341,https://www.imdb.com/title/tt1403865/,https://raw.githubusercontent.com/eledah/imdb-delta/main/thumbnails/tt1403865.jpg,"Drama, Western"
950,Despicable Me,1074,516,558,https://www.imdb.com/title/tt1323594/,https://raw.githubusercontent.com/eledah/imdb-delta/main/thumbnails/tt1323594.jpg,"Animation, Adventure, Comedy"
951,Rise of the Planet of the Apes,1110,1200,-90,https://www.imdb.com/title/tt1318514/,https://raw.githubusercontent.com/eledah/imdb-delta/main/thumbnails/tt1318514.jpg,"Action, Drama, Sci-Fi"
952,A Single Man,1267,663,604,https://www.imdb.com/title/tt1315981/,https://raw.githubusercontent.com/eledah/imdb-delta/main/thumbnails/tt1315981.jpg,"Crime, Drama, Romance"
953,50/50,878,998,-120,https://www.imdb.com/title/tt1306980/,https://raw.githubusercontent.com/eledah/imdb-delta/main/thumbnails/tt1306980.jpg,"Comedy, Drama, Romance"
954,Kick-Ass,840,1465,-625,https://www.imdb.com/title/tt1250777/,https://raw.githubusercontent.com/eledah/imdb-delta/main/thumbnails/tt1250777.jpg,"Action, Comedy, Crime"
956,Moneyball,881,1717,-836,https://www.imdb.com/title/tt1210166/,https://raw.githubusercontent.com/eledah/imdb-delta/main/thumbnails/tt1210166.jpg,"Biography, Drama, Sport"
958,The Skin I Live In,951,803,148,https://www.imdb.com/title/tt1189073/,https://raw.githubusercontent.com/eledah/imdb-delta/main/thumbnails/tt1189073.jpg,"Drama, Mystery, Thriller"
959,Zombieland,978,1054,-76,https://www.imdb.com/title/tt1156398/,https://raw.githubusercontent.com/eledah/imdb-delta/main/thumbnails/tt1156398.jpg,"Action, Comedy, Horror"
962,The Wave,973,715,258,https://www.imdb.com/title/tt1063669/,https://raw.githubusercontent.com/eledah/imdb-delta/main/thumbnails/tt1063669.jpg,"Drama, Thriller"
964,Sherlock Holmes,1016,892,124,https://www.imdb.com/title/tt0988045/,https://raw.githubusercontent.com/eledah/imdb-delta/main/thumbnails/tt0988045.jpg,"Action, Adventure, Mystery"
967,The Reader,1095,689,406,https://www.imdb.com/title/tt0976051/,https://raw.githubusercontent.com/eledah/imdb-delta/main/thumbnails/tt0976051.jpg,"Drama, Mystery, Romance"
968,The Blind Side,1078,458,620,https://www.imdb.com/title/tt0878804/,https://raw.githubusercontent.com/eledah/imdb-delta/main/thumbnails/tt0878804.jpg,"Biography, Drama, Sport"
970,Superbad,964,1856,-892,https://www.imdb.com/title/tt0829482/,https://raw.githubusercontent.com/eledah/imdb-delta/main/thumbnails/tt0829482.jpg,Comedy
971,The Book Thief,1309,529,780,https://www.imdb.com/title/tt0816442/,https://raw.githubusercontent.com/eledah/imdb-delta/main/thumbnails/tt0816442.jpg,"Drama, War"
972,Seven Pounds,959,793,166,https://www.imdb.com/title/tt0814314/,https://raw.githubusercontent.com/eledah/imdb-delta/main/thumbnails/tt0814314.jpg,"Drama, Mystery, Thriller"
974,Eastern Promises,946,992,-46,https://www.imdb.com/title/tt0765443/,https://raw.githubusercontent.com/eledah/imdb-delta/main/thumbnails/tt0765443.jpg,"Crime, Drama, Thriller"
975,Stardust,1026,737,289,https://www.imdb.com/title/tt0486655/,https://raw.githubusercontent.com/eledah/imdb-delta/main/thumbnails/tt0486655.jpg,"Adventure, Family, Fantasy"
979,Inside Man,930,1236,-306,https://www.imdb.com/title/tt0454848/,https://raw.githubusercontent.com/eledah/imdb-delta/main/thumbnails/tt0454848.jpg,"Crime, Drama, Mystery"
980,Gone Baby Gone,932,1241,-309,https://www.imdb.com/title/tt0452623/,https://raw.githubusercontent.com/eledah/imdb-delta/main/thumbnails/tt0452623.jpg,"Crime, Drama, Mystery"
985,The Illusionist,923,958,-35,https://www.imdb.com/title/tt0443543/,https://raw.githubusercontent.com/eledah/imdb-delta/main/thumbnails/tt0443543.jpg,"Drama, Fantasy, Mystery"
987,Kung Fu Panda,970,1466,-496,https://www.imdb.com/title/tt0441773/,https://raw.githubusercontent.com/eledah/imdb-delta/main/thumbnails/tt0441773.jpg,"Animation, Action, Adventure"
988,Thank You for Smoking,986,1495,-509,https://www.imdb.com/title/tt0427944/,https://raw.githubusercontent.com/eledah/imdb-delta/main/thumbnails/tt0427944.jpg,"Comedy, Drama"
992,Harry Potter and the Half-Blood Prince,1336,417,919,https://www.imdb.com/title/tt0417741/,https://raw.githubusercontent.com/eledah/imdb-delta/main/thumbnails/tt0417741.jpg,"Action, Adventure, Family"
993,300,853,1365,-512,https://www.imdb.com/title/tt0416449/,https://raw.githubusercontent.com/eledah/imdb-delta/main/thumbnails/tt0416449.jpg,"Action, Drama"
994,Match Point,839,1293,-454,https://www.imdb.com/title/tt0416320/,https://raw.githubusercontent.com/eledah/imdb-delta/main/thumbnails/tt0416320.jpg,"Drama, Romance, Thriller"
995,Watchmen,789,1843,-1054,https://www.imdb.com/title/tt0409459/,https://raw.githubusercontent.com/eledah/imdb-delta/main/thumbnails/tt0409459.jpg,"Action, Drama, Mystery"
996,Lord of War,998,1476,-478,https://www.imdb.com/title/tt0399295/,https://raw.githubusercontent.com/eledah/imdb-delta/main/thumbnails/tt0399295.jpg,"Crime, Drama"
997,Saw,882,1306,-424,https://www.imdb.com/title/tt0387564/,https://raw.githubusercontent.com/eledah/imdb-delta/main/thumbnails/tt0387564.jpg,"Horror, Mystery, Thriller"
1004,21 Grams,831,771,60,https://www.imdb.com/title/tt0315733/,https://raw.githubusercontent.com/eledah/imdb-delta/main/thumbnails/tt0315733.jpg,"Crime, Drama, Thriller"
1005,Love Actually,1186,627,559,https://www.imdb.com/title/tt0314331/,https://raw.githubusercontent.com/eledah/imdb-delta/main/thumbnails/tt0314331.jpg,"Comedy, Drama, Romance"
1007,Finding Neverland,947,632,315,https://www.imdb.com/title/tt0308644/,https://raw.githubusercontent.com/eledah/imdb-delta/main/thumbnails/tt0308644.jpg,"Biography, Drama, Family"
1008,25th Hour,850,1094,-244,https://www.imdb.com/title/tt0307901/,https://raw.githubusercontent.com/eledah/imdb-delta/main/thumbnails/tt0307901.jpg,Drama
1009,The Life of David Gale,1162,538,624,https://www.imdb.com/title/tt0289992/,https://raw.githubusercontent.com/eledah/imdb-delta/main/thumbnails/tt0289992.jpg,"Crime, Drama, Mystery"
1010,The Butterfly Effect,818,987,-169,https://www.imdb.com/title/tt0289879/,https://raw.githubusercontent.com/eledah/imdb-delta/main/thumbnails/tt0289879.jpg,"Drama, Sci-Fi, Thriller"
1011,28 Days Later...,1031,1150,-119,https://www.imdb.com/title/tt0289043/,https://raw.githubusercontent.com/eledah/imdb-delta/main/thumbnails/tt0289043.jpg,"Drama, Horror, Sci-Fi"
1012,Battle Royale,984,911,73,https://www.imdb.com/title/tt0266308/,https://raw.githubusercontent.com/eledah/imdb-delta/main/thumbnails/tt0266308.jpg,"Action, Adventure, Drama"
1013,The Royal Tenenbaums,1041,907,134,https://www.imdb.com/title/tt0265666/,https://raw.githubusercontent.com/eledah/imdb-delta/main/thumbnails/tt0265666.jpg,"Comedy, Drama"
1014,Y Tu Mamá También,875,1269,-394,https://www.imdb.com/title/tt0245574/,https://raw.githubusercontent.com/eledah/imdb-delta/main/thumbnails/tt0245574.jpg,Drama
1015,Harry Potter and the Sorcerer's Stone,1363,253,1110,https://www.imdb.com/title/tt0241527/,https://raw.githubusercontent.com/eledah/imdb-delta/main/thumbnails/tt0241527.jpg,"Adventure, Family, Fantasy"
1017,The Others,1062,850,212,https://www.imdb.com/title/tt0230600/,https://raw.githubusercontent.com/eledah/imdb-delta/main/thumbnails/tt0230600.jpg,"Horror, Mystery, Thriller"
1018,Blow,1012,1223,-211,https://www.imdb.com/title/tt0221027/,https://raw.githubusercontent.com/eledah/imdb-delta/main/thumbnails/tt0221027.jpg,"Biography, Crime, Drama"
1019,Enemy at the Gates,934,1232,-298,https://www.imdb.com/title/tt0215750/,https://raw.githubusercontent.com/eledah/imdb-delta/main/thumbnails/tt0215750.jpg,"Action, Drama, War"
1020,Moulin Rouge!,1364,533,831,https://www.imdb.com/title/tt0203009/,https://raw.githubusercontent.com/eledah/imdb-delta/main/thumbnails/tt0203009.jpg,"Drama, Musical, Romance"
1021,Traffic,979,1533,-554,https://www.imdb.com/title/tt0181865/,https://raw.githubusercontent.com/eledah/imdb-delta/main/thumbnails/tt0181865.jpg,"Crime, Drama, Thriller"
1022,Minority Report,935,1239,-304,https://www.imdb.com/title/tt0181689/,https://raw.githubusercontent.com/eledah/imdb-delta/main/thumbnails/tt0181689.jpg,"Action, Crime, Mystery"
1026,American Psycho,968,1249,-281,https://www.imdb.com/title/tt0144084/,https://raw.githubusercontent.com/eledah/imdb-delta/main/thumbnails/tt0144084.jpg,"Crime, Drama, Horror"
1027,Run Lola Run,920,729,191,https://www.imdb.com/title/tt0130827/,https://raw.githubusercontent.com/eledah/imdb-delta/main/thumbnails/tt0130827.jpg,"Action, Crime, Thriller"
1028,The Thin Red Line,849,1207,-358,https://www.imdb.com/title/tt0120863/,https://raw.githubusercontent.com/eledah/imdb-delta/main/thumbnails/tt0120863.jpg,"Drama, History, War"
1030,Mulan,1360,278,1082,https://www.imdb.com/title/tt0120762/,https://raw.githubusercontent.com/eledah/imdb-delta/main/thumbnails/tt0120762.jpg,"Animation, Adventure, Comedy"
1031,Fear and Loathing in Las Vegas,910,1426,-516,https://www.imdb.com/title/tt0120669/,https://raw.githubusercontent.com/eledah/imdb-delta/main/thumbnails/tt0120669.jpg,"Adventure, Comedy, Drama"
1033,Dark City,848,1140,-292,https://www.imdb.com/title/tt0118929/,https://raw.githubusercontent.com/eledah/imdb-delta/main/thumbnails/tt0118929.jpg,"Fantasy, Mystery, Sci-Fi"
1034,Star Trek: First Contact,1067,1000,67,https://www.imdb.com/title/tt0117731/,https://raw.githubusercontent.com/eledah/imdb-delta/main/thumbnails/tt0117731.jpg,"Action, Adventure, Drama"
1035,Sleepers,1010,731,279,https://www.imdb.com/title/tt0117665/,https://raw.githubusercontent.com/eledah/imdb-delta/main/thumbnails/tt0117665.jpg,"Crime, Drama, Thriller"
1036,Lost Highway,983,1319,-336,https://www.imdb.com/title/tt0116922/,https://raw.githubusercontent.com/eledah/imdb-delta/main/thumbnails/tt0116922.jpg,"Drama, Mystery, Thriller"
1037,Sense and Sensibility,1347,554,793,https://www.imdb.com/title/tt0114388/,https://raw.githubusercontent.com/eledah/imdb-delta/main/thumbnails/tt0114388.jpg,"Drama, Romance"
1038,Die Hard with a Vengeance,905,1308,-403,https://www.imdb.com/title/tt0112864/,https://raw.githubusercontent.com/eledah/imdb-delta/main/thumbnails/tt0112864.jpg,"Action, Adventure, Thriller"
1041,Apollo 13,876,1030,-154,https://www.imdb.com/title/tt0112384/,https://raw.githubusercontent.com/eledah/imdb-delta/main/thumbnails/tt0112384.jpg,"Adventure, Drama, History"
1044,Legends of the Fall,1211,836,375,https://www.imdb.com/title/tt0110322/,https://raw.githubusercontent.com/eledah/imdb-delta/main/thumbnails/tt0110322.jpg,"Drama, Romance, War"
1045,The Crow,1188,681,507,https://www.imdb.com/title/tt0109506/,https://raw.githubusercontent.com/eledah/imdb-delta/main/thumbnails/tt0109506.jpg,"Action, Crime, Drama"
1049,Falling Down,975,1514,-539,https://www.imdb.com/title/tt0106856/,https://raw.githubusercontent.com/eledah/imdb-delta/main/thumbnails/tt0106856.jpg,"Action, Crime, Drama"
1050,Dazed and Confused,961,1515,-554,https://www.imdb.com/title/tt0106677/,https://raw.githubusercontent.com/eledah/imdb-delta/main/thumbnails/tt0106677.jpg,Comedy
1051,My Cousin Vinny,1079,1051,28,https://www.imdb.com/title/tt0104952/,https://raw.githubusercontent.com/eledah/imdb-delta/main/thumbnails/tt0104952.jpg,"Comedy, Crime"
1056,The Hunt for Red October,1032,1370,-338,https://www.imdb.com/title/tt0099810/,https://raw.githubusercontent.com/eledah/imdb-delta/main/thumbnails/tt0099810.jpg,"Action, Adventure, Thriller"
1057,Home Alone,1057,886,171,https://www.imdb.com/title/tt0099785/,https://raw.githubusercontent.com/eledah/imdb-delta/main/thumbnails/tt0099785.jpg,"Comedy, Family"
1058,The Godfather: Part III,957,1032,-75,https://www.imdb.com/title/tt0099674/,https://raw.githubusercontent.com/eledah/imdb-delta/main/thumbnails/tt0099674.jpg,"Crime, Drama"
1059,When Harry Met Sally...,1013,921,92,https://www.imdb.com/title/tt0098635/,https://raw.githubusercontent.com/eledah/imdb-delta/main/thumbnails/tt0098635.jpg,"Comedy, Drama, Romance"
1060,National Lampoon's Christmas Vacation,1167,1120,47,https://www.imdb.com/title/tt0097958/,https://raw.githubusercontent.com/eledah/imdb-delta/main/thumbnails/tt0097958.jpg,Comedy
1062,The Little Mermaid,1549,265,1284,https://www.imdb.com/title/tt0097757/,https://raw.githubusercontent.com/eledah/imdb-delta/main/thumbnails/tt0097757.jpg,"Animation, Adventure, Family"
1064,The Naked Gun: From the Files of Police Squad!,909,1918,-1009,https://www.imdb.com/title/tt0095705/,https://raw.githubusercontent.com/eledah/imdb-delta/main/thumbnails/tt0095705.jpg,"Comedy, Crime"
1068,RoboCop,999,1934,-935,https://www.imdb.com/title/tt0093870/,https://raw.githubusercontent.com/eledah/imdb-delta/main/thumbnails/tt0093870.jpg,"Action, Crime, Sci-Fi"
1069,"Planes, Trains & Automobiles",993,1554,-561,https://www.imdb.com/title/tt0093748/,https://raw.githubusercontent.com/eledah/imdb-delta/main/thumbnails/tt0093748.jpg,"Comedy, Drama"
1070,Lethal Weapon,901,1367,-466,https://www.imdb.com/title/tt0093409/,https://raw.githubusercontent.com/eledah/imdb-delta/main/thumbnails/tt0093409.jpg,"Action, Crime, Thriller"
1071,The Fly,949,1738,-789,https://www.imdb.com/title/tt0091064/,https://raw.githubusercontent.com/eledah/imdb-delta/main/thumbnails/tt0091064.jpg,"Drama, Horror, Sci-Fi"
1073,Indiana Jones and the Temple of Doom,1050,1145,-95,https://www.imdb.com/title/tt0087469/,https://raw.githubusercontent.com/eledah/imdb-delta/main/thumbnails/tt0087469.jpg,"Action, Adventure"
1078,The Road Warrior,873,1805,-932,https://www.imdb.com/title/tt0082694/,https://raw.githubusercontent.com/eledah/imdb-delta/main/thumbnails/tt0082694.jpg,"Action, Adventure, Sci-Fi"
1082,Escape from Alcatraz,974,1220,-246,https://www.imdb.com/title/tt0079116/,https://raw.githubusercontent.com/eledah/imdb-delta/main/thumbnails/tt0079116.jpg,"Action, Biography, Crime"
1086,Close Encounters of the Third Kind,894,1278,-384,https://www.imdb.com/title/tt0075860/,https://raw.githubusercontent.com/eledah/imdb-delta/main/thumbnails/tt0075860.jpg,"Drama, Sci-Fi"
1088,Robin Hood,1086,843,243,https://www.imdb.com/title/tt0070608/,https://raw.githubusercontent.com/eledah/imdb-delta/main/thumbnails/tt0070608.jpg,"Animation, Adventure, Comedy"
1097,The Jungle Book,924,1069,-145,https://www.imdb.com/title/tt0061852/,https://raw.githubusercontent.com/eledah/imdb-delta/main/thumbnails/tt0061852.jpg,"Animation, Adventure, Comedy"
1104,Breakfast at Tiffany's,1133,475,658,https://www.imdb.com/title/tt0054698/,https://raw.githubusercontent.com/eledah/imdb-delta/main/thumbnails/tt0054698.jpg,"Comedy, Drama, Romance"
1115,Snow White and the Seven Dwarfs,991,893,98,https://www.imdb.com/title/tt0029583/,https://raw.githubusercontent.com/eledah/imdb-delta/main/thumbnails/tt0029583.jpg,"Animation, Adventure, Family"
1121,The Lighthouse,1272,1930,-658,https://www.imdb.com/title/tt7984734/,https://raw.githubusercontent.com/eledah/imdb-delta/main/thumbnails/tt7984734.jpg,"Drama, Fantasy, Horror"
1122,BlacKkKlansman,1341,908,433,https://www.imdb.com/title/tt7349662/,https://raw.githubusercontent.com/eledah/imdb-delta/main/thumbnails/tt7349662.jpg,"Biography, Comedy, Crime"
1125,Tenet,1357,1737,-380,https://www.imdb.com/title/tt6723592/,https://raw.githubusercontent.com/eledah/imdb-delta/main/thumbnails/tt6723592.jpg,"Action, Sci-Fi, Thriller"
1126,A Quiet Place,1237,1078,159,https://www.imdb.com/title/tt6644200/,https://raw.githubusercontent.com/eledah/imdb-delta/main/thumbnails/tt6644200.jpg,"Drama, Horror, Sci-Fi"
1127,Upgrade,1089,1552,-463,https://www.imdb.com/title/tt6499752/,https://raw.githubusercontent.com/eledah/imdb-delta/main/thumbnails/tt6499752.jpg,"Action, Sci-Fi, Thriller"
1128,Spider-Man: Far from Home,1318,903,415,https://www.imdb.com/title/tt6320628/,https://raw.githubusercontent.com/eledah/imdb-delta/main/thumbnails/tt6320628.jpg,"Action, Adventure, Comedy"
1129,Phantom Thread,1147,1795,-648,https://www.imdb.com/title/tt5776858/,https://raw.githubusercontent.com/eledah/imdb-delta/main/thumbnails/tt5776858.jpg,"Drama, Romance"
1131,"I, Tonya",1276,1212,64,https://www.imdb.com/title/tt5580036/,https://raw.githubusercontent.com/eledah/imdb-delta/main/thumbnails/tt5580036.jpg,"Biography, Comedy, Drama"
1132,The Big Sick,1049,1355,-306,https://www.imdb.com/title/tt5462602/,https://raw.githubusercontent.com/eledah/imdb-delta/main/thumbnails/tt5462602.jpg,"Comedy, Drama, Romance"
1135,The Favourite,1030,1419,-389,https://www.imdb.com/title/tt5083738/,https://raw.githubusercontent.com/eledah/imdb-delta/main/thumbnails/tt5083738.jpg,"Biography, Comedy, Drama"
1136,Nocturnal Animals,1159,1479,-320,https://www.imdb.com/title/tt4550098/,https://raw.githubusercontent.com/eledah/imdb-delta/main/thumbnails/tt4550098.jpg,"Drama, Thriller"
1138,John Wick: Chapter 2,1323,1608,-285,https://www.imdb.com/title/tt4425200/,https://raw.githubusercontent.com/eledah/imdb-delta/main/thumbnails/tt4425200.jpg,"Action, Crime, Thriller"
1143,Still Alice,1274,963,311,https://www.imdb.com/title/tt3316960/,https://raw.githubusercontent.com/eledah/imdb-delta/main/thumbnails/tt3316960.jpg,Drama
1147,Predestination,1168,1387,-219,https://www.imdb.com/title/tt2397535/,https://raw.githubusercontent.com/eledah/imdb-delta/main/thumbnails/tt2397535.jpg,"Action, Drama, Sci-Fi"
1148,How to Train Your Dragon: The Hidden World,1469,673,796,https://www.imdb.com/title/tt2386490/,https://raw.githubusercontent.com/eledah/imdb-delta/main/thumbnails/tt2386490.jpg,"Animation, Action, Adventure"
1149,Brooklyn,1296,1060,236,https://www.imdb.com/title/tt2381111/,https://raw.githubusercontent.com/eledah/imdb-delta/main/thumbnails/tt2381111.jpg,"Drama, Romance"
1153,Saving Mr. Banks,1382,927,455,https://www.imdb.com/title/tt2140373/,https://raw.githubusercontent.com/eledah/imdb-delta/main/thumbnails/tt2140373.jpg,"Biography, Comedy, Drama"
1155,Inside Llewyn Davis,1164,1837,-673,https://www.imdb.com/title/tt2042568/,https://raw.githubusercontent.com/eledah/imdb-delta/main/thumbnails/tt2042568.jpg,"Drama, Music"
1156,The Hunger Games: Catching Fire,1367,360,1007,https://www.imdb.com/title/tt1951264/,https://raw.githubusercontent.com/eledah/imdb-delta/main/thumbnails/tt1951264.jpg,"Action, Adventure, Sci-Fi"
1158,127 Hours,944,1208,-264,https://www.imdb.com/title/tt1542344/,https://raw.githubusercontent.com/eledah/imdb-delta/main/thumbnails/tt1542344.jpg,"Biography, Drama"
1159,Sherlock Holmes: A Game of Shadows,1213,1064,149,https://www.imdb.com/title/tt1515091/,https://raw.githubusercontent.com/eledah/imdb-delta/main/thumbnails/tt1515091.jpg,"Action, Adventure, Mystery"
1161,Tucker and Dale vs Evil,1087,1087,0,https://www.imdb.com/title/tt1465522/,https://raw.githubusercontent.com/eledah/imdb-delta/main/thumbnails/tt1465522.jpg,"Comedy, Horror"
1162,The Conjuring,1227,1273,-46,https://www.imdb.com/title/tt1457767/,https://raw.githubusercontent.com/eledah/imdb-delta/main/thumbnails/tt1457767.jpg,"Horror, Mystery, Thriller"
1168,We Need to Talk About Kevin,1262,847,415,https://www.imdb.com/title/tt1242460/,https://raw.githubusercontent.com/eledah/imdb-delta/main/thumbnails/tt1242460.jpg,"Drama, Mystery, Thriller"
1170,Doctor Strange,1209,961,248,https://www.imdb.com/title/tt1211837/,https://raw.githubusercontent.com/eledah/imdb-delta/main/thumbnails/tt1211837.jpg,"Action, Adventure, Fantasy"
1172,Lone Survivor,1189,898,291,https://www.imdb.com/title/tt1091191/,https://raw.githubusercontent.com/eledah/imdb-delta/main/thumbnails/tt1091191.jpg,"Action, Biography, Drama"
1175,Milk,1150,830,320,https://www.imdb.com/title/tt1013753/,https://raw.githubusercontent.com/eledah/imdb-delta/main/thumbnails/tt1013753.jpg,"Biography, Drama, History"
1176,Hugo,1202,1104,98,https://www.imdb.com/title/tt0970179/,https://raw.githubusercontent.com/eledah/imdb-delta/main/thumbnails/tt0970179.jpg,"Adventure, Drama, Family"
1177,Source Code,1192,1452,-260,https://www.imdb.com/title/tt0945513/,https://raw.githubusercontent.com/eledah/imdb-delta/main/thumbnails/tt0945513.jpg,"Action, Drama, Mystery"
1178,Doubt,1105,1371,-266,https://www.imdb.com/title/tt0918927/,https://raw.githubusercontent.com/eledah/imdb-delta/main/thumbnails/tt0918927.jpg,"Drama, Mystery"
1179,The Hurt Locker,1045,1361,-316,https://www.imdb.com/title/tt0887912/,https://raw.githubusercontent.com/eledah/imdb-delta/main/thumbnails/tt0887912.jpg,"Drama, Thriller, War"
1180,The Town,1072,1585,-513,https://www.imdb.com/title/tt0840361/,https://raw.githubusercontent.com/eledah/imdb-delta/main/thumbnails/tt0840361.jpg,"Crime, Drama, Thriller"
1185,Grindhouse,1053,1020,33,https://www.imdb.com/title/tt0462322/,https://raw.githubusercontent.com/eledah/imdb-delta/main/thumbnails/tt0462322.jpg,"Action, Horror, Thriller"
1189,Scott Pilgrim vs. the World,1081,1617,-536,https://www.imdb.com/title/tt0446029/,https://raw.githubusercontent.com/eledah/imdb-delta/main/thumbnails/tt0446029.jpg,"Action, Comedy, Fantasy"
1190,The Assassination of Jesse James by the Coward Robert Ford,1178,1670,-492,https://www.imdb.com/title/tt0443680/,https://raw.githubusercontent.com/eledah/imdb-delta/main/thumbnails/tt0443680.jpg,"Biography, Crime, Drama"
1192,August Rush,1411,750,661,https://www.imdb.com/title/tt0426931/,https://raw.githubusercontent.com/eledah/imdb-delta/main/thumbnails/tt0426931.jpg,"Drama, Music"
1193,Stranger Than Fiction,1022,1142,-120,https://www.imdb.com/title/tt0420223/,https://raw.githubusercontent.com/eledah/imdb-delta/main/thumbnails/tt0420223.jpg,"Comedy, Drama, Fantasy"
1196,Munich,1006,1576,-570,https://www.imdb.com/title/tt0408306/,https://raw.githubusercontent.com/eledah/imdb-delta/main/thumbnails/tt0408306.jpg,"Action, Drama, History"
1197,Little Children,1138,1492,-354,https://www.imdb.com/title/tt0404203/,https://raw.githubusercontent.com/eledah/imdb-delta/main/thumbnails/tt0404203.jpg,"Drama, Romance"
1198,Perfume: The Story of a Murderer,1157,1153,4,https://www.imdb.com/title/tt0396171/,https://raw.githubusercontent.com/eledah/imdb-delta/main/thumbnails/tt0396171.jpg,"Crime, Drama, Fantasy"
1199,House of Flying Daggers,1230,774,456,https://www.imdb.com/title/tt0385004/,https://raw.githubusercontent.com/eledah/imdb-delta/main/thumbnails/tt0385004.jpg,"Action, Adventure, Drama"
1200,Green Street Hooligans,1248,1115,133,https://www.imdb.com/title/tt0385002/,https://raw.githubusercontent.com/eledah/imdb-delta/main/thumbnails/tt0385002.jpg,"Crime, Drama, Sport"
1201,Sideways,1112,1941,-829,https://www.imdb.com/title/tt0375063/,https://raw.githubusercontent.com/eledah/imdb-delta/main/thumbnails/tt0375063.jpg,"Comedy, Drama, Romance"
1202,Harry Potter and the Order of the Phoenix,1395,464,931,https://www.imdb.com/title/tt0373889/,https://raw.githubusercontent.com/eledah/imdb-delta/main/thumbnails/tt0373889.jpg,"Action, Adventure, Family"
1203,Kiss Kiss Bang Bang,1044,1324,-280,https://www.imdb.com/title/tt0373469/,https://raw.githubusercontent.com/eledah/imdb-delta/main/thumbnails/tt0373469.jpg,"Comedy, Crime, Mystery"
1204,Collateral,996,1835,-839,https://www.imdb.com/title/tt0369339/,https://raw.githubusercontent.com/eledah/imdb-delta/main/thumbnails/tt0369339.jpg,"Action, Crime, Drama"
1209,The Aviator,1118,1494,-376,https://www.imdb.com/title/tt0338751/,https://raw.githubusercontent.com/eledah/imdb-delta/main/thumbnails/tt0338751.jpg,"Biography, Drama"
1213,The Hours,1314,864,450,https://www.imdb.com/title/tt0274558/,https://raw.githubusercontent.com/eledah/imdb-delta/main/thumbnails/tt0274558.jpg,"Drama, Romance"
1214,Ice Age,1096,770,326,https://www.imdb.com/title/tt0268380/,https://raw.githubusercontent.com/eledah/imdb-delta/main/thumbnails/tt0268380.jpg,"Animation, Adventure, Comedy"
1217,The Man Who Wasn't There,1007,1363,-356,https://www.imdb.com/title/tt0243133/,https://raw.githubusercontent.com/eledah/imdb-delta/main/thumbnails/tt0243133.jpg,"Crime, Drama"
1219,Gangs of New York,985,1616,-631,https://www.imdb.com/title/tt0217505/,https://raw.githubusercontent.com/eledah/imdb-delta/main/thumbnails/tt0217505.jpg,"Crime, Drama"
1226,High Fidelity,1193,1527,-334,https://www.imdb.com/title/tt0146882/,https://raw.githubusercontent.com/eledah/imdb-delta/main/thumbnails/tt0146882.jpg,"Comedy, Drama, Music"
1228,Star Wars: Episode III - Revenge of the Sith,1103,1398,-295,https://www.imdb.com/title/tt0121766/,https://raw.githubusercontent.com/eledah/imdb-delta/main/thumbnails/tt0121766.jpg,"Action, Adventure, Fantasy"
1229,Pleasantville,1261,991,270,https://www.imdb.com/title/tt0120789/,https://raw.githubusercontent.com/eledah/imdb-delta/main/thumbnails/tt0120789.jpg,"Comedy, Drama, Fantasy"
1233,Jackie Brown,1135,1271,-136,https://www.imdb.com/title/tt0119396/,https://raw.githubusercontent.com/eledah/imdb-delta/main/thumbnails/tt0119396.jpg,"Crime, Drama, Thriller"
1234,The Devil's Advocate,1175,1077,98,https://www.imdb.com/title/tt0118971/,https://raw.githubusercontent.com/eledah/imdb-delta/main/thumbnails/tt0118971.jpg,"Drama, Fantasy, Mystery"
1237,A Time to Kill,1322,816,506,https://www.imdb.com/title/tt0117913/,https://raw.githubusercontent.com/eledah/imdb-delta/main/thumbnails/tt0117913.jpg,"Crime, Drama, Thriller"
1238,Leaving Las Vegas,1111,1632,-521,https://www.imdb.com/title/tt0113627/,https://raw.githubusercontent.com/eledah/imdb-delta/main/thumbnails/tt0113627.jpg,"Drama, Romance"
1242,Interview with the Vampire: The Vampire Chronicles,1142,773,369,https://www.imdb.com/title/tt0110148/,https://raw.githubusercontent.com/eledah/imdb-delta/main/thumbnails/tt0110148.jpg,"Drama, Fantasy, Horror"
1247,Army of Darkness,1210,1471,-261,https://www.imdb.com/title/tt0106308/,https://raw.githubusercontent.com/eledah/imdb-delta/main/thumbnails/tt0106308.jpg,"Comedy, Horror"
1253,Thelma & Louise,1349,675,674,https://www.imdb.com/title/tt0103074/,https://raw.githubusercontent.com/eledah/imdb-delta/main/thumbnails/tt0103074.jpg,"Adventure, Crime, Drama"
1255,Total Recall,1023,1776,-753,https://www.imdb.com/title/tt0100802/,https://raw.githubusercontent.com/eledah/imdb-delta/main/thumbnails/tt0100802.jpg,"Action, Adventure, Sci-Fi"
1258,Field of Dreams,1165,1542,-377,https://www.imdb.com/title/tt0097351/,https://raw.githubusercontent.com/eledah/imdb-delta/main/thumbnails/tt0097351.jpg,"Drama, Family, Fantasy"
1259,Batman,1102,1345,-243,https://www.imdb.com/title/tt0096895/,https://raw.githubusercontent.com/eledah/imdb-delta/main/thumbnails/tt0096895.jpg,"Action, Adventure"
1260,The Abyss,982,1281,-299,https://www.imdb.com/title/tt0096754/,https://raw.githubusercontent.com/eledah/imdb-delta/main/thumbnails/tt0096754.jpg,"Adventure, Drama, Mystery"
1263,A Fish Called Wanda,1108,1298,-190,https://www.imdb.com/title/tt0095159/,https://raw.githubusercontent.com/eledah/imdb-delta/main/thumbnails/tt0095159.jpg,"Comedy, Crime"
1264,Beetlejuice,1243,905,338,https://www.imdb.com/title/tt0094721/,https://raw.githubusercontent.com/eledah/imdb-delta/main/thumbnails/tt0094721.jpg,"Comedy, Fantasy"
1268,A Nightmare on Elm Street,1185,1435,-250,https://www.imdb.com/title/tt0087800/,https://raw.githubusercontent.com/eledah/imdb-delta/main/thumbnails/tt0087800.jpg,Horror
1270,Trading Places,1197,1507,-310,https://www.imdb.com/title/tt0086465/,https://raw.githubusercontent.com/eledah/imdb-delta/main/thumbnails/tt0086465.jpg,Comedy
1271,The Meaning of Life,1136,1014,122,https://www.imdb.com/title/tt0085959/,https://raw.githubusercontent.com/eledah/imdb-delta/main/thumbnails/tt0085959.jpg,"Comedy, Musical"
1272,The Evil Dead,1140,1729,-589,https://www.imdb.com/title/tt0083907/,https://raw.githubusercontent.com/eledah/imdb-delta/main/thumbnails/tt0083907.jpg,Horror
1276,National Lampoon's Animal House,1073,1742,-669,https://www.imdb.com/title/tt0077975/,https://raw.githubusercontent.com/eledah/imdb-delta/main/thumbnails/tt0077975.jpg,Comedy
1277,The Omen,1052,1337,-285,https://www.imdb.com/title/tt0075005/,https://raw.githubusercontent.com/eledah/imdb-delta/main/thumbnails/tt0075005.jpg,"Horror, Mystery"
1280,The Texas Chain Saw Massacre,1183,1846,-663,https://www.imdb.com/title/tt0072271/,https://raw.githubusercontent.com/eledah/imdb-delta/main/thumbnails/tt0072271.jpg,Horror
1296,Onward,1476,994,482,https://www.imdb.com/title/tt7146812/,https://raw.githubusercontent.com/eledah/imdb-delta/main/thumbnails/tt7146812.jpg,"Animation, Adventure, Comedy"
1300,John Wick: Chapter 3 - Parabellum,1403,1501,-98,https://www.imdb.com/title/tt6146586/,https://raw.githubusercontent.com/eledah/imdb-delta/main/thumbnails/tt6146586.jpg,"Action, Crime, Thriller"
1301,Uncut Gems,1215,1993,-778,https://www.imdb.com/title/tt5727208/,https://raw.githubusercontent.com/eledah/imdb-delta/main/thumbnails/tt5727208.jpg,"Crime, Drama, Thriller"
1304,Moonlight,1462,1093,369,https://www.imdb.com/title/tt4975722/,https://raw.githubusercontent.com/eledah/imdb-delta/main/thumbnails/tt4975722.jpg,Drama
1305,Lady Bird,1345,1589,-244,https://www.imdb.com/title/tt4925292/,https://raw.githubusercontent.com/eledah/imdb-delta/main/thumbnails/tt4925292.jpg,"Comedy, Drama"
1308,Darkest Hour,1377,1372,5,https://www.imdb.com/title/tt4555426/,https://raw.githubusercontent.com/eledah/imdb-delta/main/thumbnails/tt4555426.jpg,"Drama, War"
1309,Molly's Game,1283,1137,146,https://www.imdb.com/title/tt4209788/,https://raw.githubusercontent.com/eledah/imdb-delta/main/thumbnails/tt4209788.jpg,"Biography, Crime, Drama"
1311,The Nice Guys,1396,1792,-396,https://www.imdb.com/title/tt3799694/,https://raw.githubusercontent.com/eledah/imdb-delta/main/thumbnails/tt3799694.jpg,"Action, Comedy, Crime"
1314,The Disaster Artist,1428,1702,-274,https://www.imdb.com/title/tt3521126/,https://raw.githubusercontent.com/eledah/imdb-delta/main/thumbnails/tt3521126.jpg,"Biography, Comedy, Drama"
1315,War for the Planet of the Apes,1331,1323,8,https://www.imdb.com/title/tt3450958/,https://raw.githubusercontent.com/eledah/imdb-delta/main/thumbnails/tt3450958.jpg,"Action, Adventure, Drama"
1316,Sully,1277,1139,138,https://www.imdb.com/title/tt3263904/,https://raw.githubusercontent.com/eledah/imdb-delta/main/thumbnails/tt3263904.jpg,"Biography, Drama"
1317,The Jungle Book,924,1069,-145,https://www.imdb.com/title/tt3040964/,https://raw.githubusercontent.com/eledah/imdb-delta/main/thumbnails/tt3040964.jpg,"Animation, Action, Adventure"
1318,John Wick,1502,1664,-162,https://www.imdb.com/title/tt2911666/,https://raw.githubusercontent.com/eledah/imdb-delta/main/thumbnails/tt2911666.jpg,"Action, Crime, Thriller"
1319,I Origins,1588,889,699,https://www.imdb.com/title/tt2884206/,https://raw.githubusercontent.com/eledah/imdb-delta/main/thumbnails/tt2884206.jpg,"Drama, Mystery, Romance"
1321,Me Before You,1851,1039,812,https://www.imdb.com/title/tt2674426/,https://raw.githubusercontent.com/eledah/imdb-delta/main/thumbnails/tt2674426.jpg,"Drama, Romance"
1325,Mission: Impossible - Rogue Nation,1371,1543,-172,https://www.imdb.com/title/tt2381249/,https://raw.githubusercontent.com/eledah/imdb-delta/main/thumbnails/tt2381249.jpg,"Action, Adventure, Thriller"
1326,The Hobbit: The Battle of the Five Armies,1437,884,553,https://www.imdb.com/title/tt2310332/,https://raw.githubusercontent.com/eledah/imdb-delta/main/thumbnails/tt2310332.jpg,"Adventure, Fantasy"
1327,Frozen,1439,614,825,https://www.imdb.com/title/tt2294629/,https://raw.githubusercontent.com/eledah/imdb-delta/main/thumbnails/tt2294629.jpg,"Animation, Adventure, Comedy"
1328,Spider-Man: Homecoming,1366,1182,184,https://www.imdb.com/title/tt2250912/,https://raw.githubusercontent.com/eledah/imdb-delta/main/thumbnails/tt2250912.jpg,"Action, Adventure, Sci-Fi"
1331,Begin Again,1346,1399,-53,https://www.imdb.com/title/tt1980929/,https://raw.githubusercontent.com/eledah/imdb-delta/main/thumbnails/tt1980929.jpg,"Comedy, Drama, Music"
1333,Mud,1275,1782,-507,https://www.imdb.com/title/tt1935179/,https://raw.githubusercontent.com/eledah/imdb-delta/main/thumbnails/tt1935179.jpg,"Adventure, Drama"
1335,The Judge,1353,1047,306,https://www.imdb.com/title/tt1872194/,https://raw.githubusercontent.com/eledah/imdb-delta/main/thumbnails/tt1872194.jpg,"Crime, Drama, Mystery"
1337,Southpaw,1456,1129,327,https://www.imdb.com/title/tt1798684/,https://raw.githubusercontent.com/eledah/imdb-delta/main/thumbnails/tt1798684.jpg,"Action, Drama, Sport"
1339,Zero Dark Thirty,1290,1578,-288,https://www.imdb.com/title/tt1790885/,https://raw.githubusercontent.com/eledah/imdb-delta/main/thumbnails/tt1790885.jpg,"Drama, History, Thriller"
1341,The Way Way Back,1406,1382,24,https://www.imdb.com/title/tt1727388/,https://raw.githubusercontent.com/eledah/imdb-delta/main/thumbnails/tt1727388.jpg,"Comedy, Drama"
1342,Ready Player One,1306,1381,-75,https://www.imdb.com/title/tt1677720/,https://raw.githubusercontent.com/eledah/imdb-delta/main/thumbnails/tt1677720.jpg,"Action, Adventure, Sci-Fi"
1345,"Crazy, Stupid, Love.",1438,1202,236,https://www.imdb.com/title/tt1570728/,https://raw.githubusercontent.com/eledah/imdb-delta/main/thumbnails/tt1570728.jpg,"Comedy, Drama, Romance"
1348,Cloud Atlas,1295,1155,140,https://www.imdb.com/title/tt1371111/,https://raw.githubusercontent.com/eledah/imdb-delta/main/thumbnails/tt1371111.jpg,"Drama, Mystery, Sci-Fi"
1351,Looper,1287,1564,-277,https://www.imdb.com/title/tt1276104/,https://raw.githubusercontent.com/eledah/imdb-delta/main/thumbnails/tt1276104.jpg,"Action, Drama, Sci-Fi"
1352,Mission: Impossible - Ghost Protocol,1383,1630,-247,https://www.imdb.com/title/tt1229238/,https://raw.githubusercontent.com/eledah/imdb-delta/main/thumbnails/tt1229238.jpg,"Action, Adventure, Thriller"
1354,Limitless,1370,1524,-154,https://www.imdb.com/title/tt1219289/,https://raw.githubusercontent.com/eledah/imdb-delta/main/thumbnails/tt1219289.jpg,"Sci-Fi, Thriller"
1355,Law Abiding Citizen,1416,1146,270,https://www.imdb.com/title/tt1197624/,https://raw.githubusercontent.com/eledah/imdb-delta/main/thumbnails/tt1197624.jpg,"Action, Crime, Drama"
1356,Up in the Air,1166,1885,-719,https://www.imdb.com/title/tt1193138/,https://raw.githubusercontent.com/eledah/imdb-delta/main/thumbnails/tt1193138.jpg,"Comedy, Drama, Romance"
1359,Pirate Radio,1410,820,590,https://www.imdb.com/title/tt1131729/,https://raw.githubusercontent.com/eledah/imdb-delta/main/thumbnails/tt1131729.jpg,"Comedy, Drama, Music"
1360,Blue Valentine,1332,1707,-375,https://www.imdb.com/title/tt1120985/,https://raw.githubusercontent.com/eledah/imdb-delta/main/thumbnails/tt1120985.jpg,"Drama, Romance"
1364,REC,1196,1832,-636,https://www.imdb.com/title/tt1038988/,https://raw.githubusercontent.com/eledah/imdb-delta/main/thumbnails/tt1038988.jpg,"Horror, Mystery, Thriller"
1367,The Bucket List,1338,1170,168,https://www.imdb.com/title/tt0825232/,https://raw.githubusercontent.com/eledah/imdb-delta/main/thumbnails/tt0825232.jpg,"Adventure, Comedy, Drama"
1368,Death at a Funeral,1520,1130,390,https://www.imdb.com/title/tt0795368/,https://raw.githubusercontent.com/eledah/imdb-delta/main/thumbnails/tt0795368.jpg,Comedy
1372,Juno,1337,1185,152,https://www.imdb.com/title/tt0467406/,https://raw.githubusercontent.com/eledah/imdb-delta/main/thumbnails/tt0467406.jpg,"Comedy, Drama"
1374,The Orphanage,1325,1109,216,https://www.imdb.com/title/tt0464141/,https://raw.githubusercontent.com/eledah/imdb-delta/main/thumbnails/tt0464141.jpg,"Drama, Horror, Mystery"
1375,Wonder Woman,1567,798,769,https://www.imdb.com/title/tt0451279/,https://raw.githubusercontent.com/eledah/imdb-delta/main/thumbnails/tt0451279.jpg,"Action, Adventure, Fantasy"
1376,Babel,1268,1267,1,https://www.imdb.com/title/tt0449467/,https://raw.githubusercontent.com/eledah/imdb-delta/main/thumbnails/tt0449467.jpg,Drama
1384,A History of Violence,1263,1831,-568,https://www.imdb.com/title/tt0399146/,https://raw.githubusercontent.com/eledah/imdb-delta/main/thumbnails/tt0399146.jpg,"Action, Crime, Drama"
1385,Memoirs of a Geisha,1895,869,1026,https://www.imdb.com/title/tt0397535/,https://raw.githubusercontent.com/eledah/imdb-delta/main/thumbnails/tt0397535.jpg,"Drama, Romance"
1388,The Constant Gardener,1380,1085,295,https://www.imdb.com/title/tt0387131/,https://raw.githubusercontent.com/eledah/imdb-delta/main/thumbnails/tt0387131.jpg,"Drama, Mystery, Romance"
1389,The Terminal,1448,1642,-194,https://www.imdb.com/title/tt0362227/,https://raw.githubusercontent.com/eledah/imdb-delta/main/thumbnails/tt0362227.jpg,"Comedy, Drama, Romance"
1390,Garden State,1266,1506,-240,https://www.imdb.com/title/tt0333766/,https://raw.githubusercontent.com/eledah/imdb-delta/main/thumbnails/tt0333766.jpg,"Comedy, Drama, Romance"
1392,Wallace & Gromit: The Curse of the Were-Rabbit,1297,1565,-268,https://www.imdb.com/title/tt0312004/,https://raw.githubusercontent.com/eledah/imdb-delta/main/thumbnails/tt0312004.jpg,"Animation, Adventure, Comedy"
1393,Master and Commander: The Far Side of the World,1344,1708,-364,https://www.imdb.com/title/tt0311113/,https://raw.githubusercontent.com/eledah/imdb-delta/main/thumbnails/tt0311113.jpg,"Action, Adventure, Drama"
1395,Harry Potter and the Chamber of Secrets,1633,559,1074,https://www.imdb.com/title/tt0295297/,https://raw.githubusercontent.com/eledah/imdb-delta/main/thumbnails/tt0295297.jpg,"Adventure, Family, Fantasy"
1396,Irreversible,1401,1620,-219,https://www.imdb.com/title/tt0290673/,https://raw.githubusercontent.com/eledah/imdb-delta/main/thumbnails/tt0290673.jpg,"Crime, Drama, Mystery"
1397,X2: X-Men United,1328,1375,-47,https://www.imdb.com/title/tt0290334/,https://raw.githubusercontent.com/eledah/imdb-delta/main/thumbnails/tt0290334.jpg,"Action, Sci-Fi, Thriller"
1398,A Walk to Remember,1694,1341,353,https://www.imdb.com/title/tt0281358/,https://raw.githubusercontent.com/eledah/imdb-delta/main/thumbnails/tt0281358.jpg,"Drama, Romance"
1400,K-PAX,1373,1439,-66,https://www.imdb.com/title/tt0272152/,https://raw.githubusercontent.com/eledah/imdb-delta/main/thumbnails/tt0272152.jpg,"Drama, Mystery, Sci-Fi"
1405,Equilibrium,1302,1126,176,https://www.imdb.com/title/tt0238380/,https://raw.githubusercontent.com/eledah/imdb-delta/main/thumbnails/tt0238380.jpg,"Action, Drama, Sci-Fi"
1407,Erin Brockovich,1595,1187,408,https://www.imdb.com/title/tt0195685/,https://raw.githubusercontent.com/eledah/imdb-delta/main/thumbnails/tt0195685.jpg,"Biography, Drama"
1408,Pi,1402,1518,-116,https://www.imdb.com/title/tt0138704/,https://raw.githubusercontent.com/eledah/imdb-delta/main/thumbnails/tt0138704.jpg,"Drama, Horror, Mystery"
1409,The Talented Mr. Ripley,1451,1179,272,https://www.imdb.com/title/tt0134119/,https://raw.githubusercontent.com/eledah/imdb-delta/main/thumbnails/tt0134119.jpg,"Crime, Drama, Thriller"
1411,Man on the Moon,1225,1687,-462,https://www.imdb.com/title/tt0125664/,https://raw.githubusercontent.com/eledah/imdb-delta/main/thumbnails/tt0125664.jpg,"Biography, Comedy, Drama"
1413,The Emperor's New Groove,1730,1008,722,https://www.imdb.com/title/tt0120917/,https://raw.githubusercontent.com/eledah/imdb-delta/main/thumbnails/tt0120917.jpg,"Animation, Adventure, Comedy"
1414,X-Men,1481,1031,450,https://www.imdb.com/title/tt0120903/,https://raw.githubusercontent.com/eledah/imdb-delta/main/thumbnails/tt0120903.jpg,"Action, Adventure, Sci-Fi"
1416,Eyes Wide Shut,1218,1975,-757,https://www.imdb.com/title/tt0120663/,https://raw.githubusercontent.com/eledah/imdb-delta/main/thumbnails/tt0120663.jpg,"Drama, Mystery, Thriller"
1419,Contact,1286,1607,-321,https://www.imdb.com/title/tt0118884/,https://raw.githubusercontent.com/eledah/imdb-delta/main/thumbnails/tt0118884.jpg,"Drama, Mystery, Sci-Fi"
1422,The Rock,1260,1605,-345,https://www.imdb.com/title/tt0117500/,https://raw.githubusercontent.com/eledah/imdb-delta/main/thumbnails/tt0117500.jpg,"Action, Adventure, Thriller"
1425,The English Patient,1460,1018,442,https://www.imdb.com/title/tt0116209/,https://raw.githubusercontent.com/eledah/imdb-delta/main/thumbnails/tt0116209.jpg,"Drama, Romance, War"
1432,Dracula,1222,1040,182,https://www.imdb.com/title/tt0103874/,https://raw.githubusercontent.com/eledah/imdb-delta/main/thumbnails/tt0103874.jpg,"Fantasy, Horror, Romance"
1433,Back to the Future Part III,1232,1484,-252,https://www.imdb.com/title/tt0099088/,https://raw.githubusercontent.com/eledah/imdb-delta/main/thumbnails/tt0099088.jpg,"Adventure, Comedy, Sci-Fi"
1436,Wall Street,1359,1924,-565,https://www.imdb.com/title/tt0094291/,https://raw.githubusercontent.com/eledah/imdb-delta/main/thumbnails/tt0094291.jpg,"Crime, Drama"
1438,Labyrinth,1692,574,1118,https://www.imdb.com/title/tt0091369/,https://raw.githubusercontent.com/eledah/imdb-delta/main/thumbnails/tt0091369.jpg,"Adventure, Family, Fantasy"
1440,The NeverEnding Story,1527,894,633,https://www.imdb.com/title/tt0088323/,https://raw.githubusercontent.com/eledah/imdb-delta/main/thumbnails/tt0088323.jpg,"Adventure, Drama, Family"
1457,Eraserhead,1433,1697,-264,https://www.imdb.com/title/tt0074486/,https://raw.githubusercontent.com/eledah/imdb-delta/main/thumbnails/tt0074486.jpg,"Fantasy, Horror"
1458,Carrie,1390,1412,-22,https://www.imdb.com/title/tt0074285/,https://raw.githubusercontent.com/eledah/imdb-delta/main/thumbnails/tt0074285.jpg,"Horror, Mystery"
1461,The Rocky Horror Picture Show,1791,514,1277,https://www.imdb.com/title/tt0073629/,https://raw.githubusercontent.com/eledah/imdb-delta/main/thumbnails/tt0073629.jpg,"Comedy, Horror, Musical"
1473,From Russia with Love,1280,1868,-588,https://www.imdb.com/title/tt0057076/,https://raw.githubusercontent.com/eledah/imdb-delta/main/thumbnails/tt0057076.jpg,"Action, Adventure, Thriller"
1477,Alice in Wonderland,1555,1072,483,https://www.imdb.com/title/tt0043274/,https://raw.githubusercontent.com/eledah/imdb-delta/main/thumbnails/tt0043274.jpg,"Animation, Adventure, Comedy"
1479,Pinocchio,1100,1741,-641,https://www.imdb.com/title/tt0032910/,https://raw.githubusercontent.com/eledah/imdb-delta/main/thumbnails/tt0032910.jpg,"Animation, Adventure, Comedy"
1480,El Camino: A Breaking Bad Movie,1533,1849,-316,https://www.imdb.com/title/tt9243946/,https://raw.githubusercontent.com/eledah/imdb-delta/main/thumbnails/tt9243946.jpg,"Action, Crime, Drama"
1483,Hereditary,1508,1965,-457,https://www.imdb.com/title/tt7784604/,https://raw.githubusercontent.com/eledah/imdb-delta/main/thumbnails/tt7784604.jpg,"Drama, Horror, Mystery"
1485,The Ballad of Buster Scruggs,1600,1787,-187,https://www.imdb.com/title/tt6412452/,https://raw.githubusercontent.com/eledah/imdb-delta/main/thumbnails/tt6412452.jpg,"Comedy, Drama, Musical"
1487,Doctor Sleep,1492,1628,-136,https://www.imdb.com/title/tt5606664/,https://raw.githubusercontent.com/eledah/imdb-delta/main/thumbnails/tt5606664.jpg,"Drama, Fantasy, Horror"
1488,The Shape of Water,1553,1534,19,https://www.imdb.com/title/tt5580390/,https://raw.githubusercontent.com/eledah/imdb-delta/main/thumbnails/tt5580390.jpg,"Drama, Fantasy, Romance"
1491,Split,1491,1391,100,https://www.imdb.com/title/tt4972582/,https://raw.githubusercontent.com/eledah/imdb-delta/main/thumbnails/tt4972582.jpg,"Horror, Thriller"
1495,13 Hours,1639,1248,391,https://www.imdb.com/title/tt4172430/,https://raw.githubusercontent.com/eledah/imdb-delta/main/thumbnails/tt4172430.jpg,"Action, Drama, History"
1496,The Lego Batman Movie,1607,1508,99,https://www.imdb.com/title/tt4116284/,https://raw.githubusercontent.com/eledah/imdb-delta/main/thumbnails/tt4116284.jpg,"Animation, Action, Adventure"
1497,Okja,1658,1117,541,https://www.imdb.com/title/tt3967856/,https://raw.githubusercontent.com/eledah/imdb-delta/main/thumbnails/tt3967856.jpg,"Action, Adventure, Drama"
1498,Snowden,1676,1519,157,https://www.imdb.com/title/tt3774114/,https://raw.githubusercontent.com/eledah/imdb-delta/main/thumbnails/tt3774114.jpg,"Biography, Crime, Drama"
1500,The Walk,1601,1675,-74,https://www.imdb.com/title/tt3488710/,https://raw.githubusercontent.com/eledah/imdb-delta/main/thumbnails/tt3488710.jpg,"Adventure, Biography, Drama"
1505,Fantastic Beasts and Where to Find Them,1804,887,917,https://www.imdb.com/title/tt3183660/,https://raw.githubusercontent.com/eledah/imdb-delta/main/thumbnails/tt3183660.jpg,"Adventure, Family, Fantasy"
1506,The Conjuring 2,1590,1637,-47,https://www.imdb.com/title/tt3065204/,https://raw.githubusercontent.com/eledah/imdb-delta/main/thumbnails/tt3065204.jpg,"Horror, Mystery, Thriller"
1508,Chef,1615,1673,-58,https://www.imdb.com/title/tt2883512/,https://raw.githubusercontent.com/eledah/imdb-delta/main/thumbnails/tt2883512.jpg,"Adventure, Comedy, Drama"
1515,Avengers: Age of Ultron,1665,1071,594,https://www.imdb.com/title/tt2395427/,https://raw.githubusercontent.com/eledah/imdb-delta/main/thumbnails/tt2395427.jpg,"Action, Adventure, Sci-Fi"
1516,Blue Jasmine,1638,1579,59,https://www.imdb.com/title/tt2334873/,https://raw.githubusercontent.com/eledah/imdb-delta/main/thumbnails/tt2334873.jpg,"Comedy, Drama, Romance"
1517,Finding Dory,1684,1080,604,https://www.imdb.com/title/tt2277860/,https://raw.githubusercontent.com/eledah/imdb-delta/main/thumbnails/tt2277860.jpg,"Animation, Adventure, Comedy"
1519,American Sniper,1628,1612,16,https://www.imdb.com/title/tt2179136/,https://raw.githubusercontent.com/eledah/imdb-delta/main/thumbnails/tt2179136.jpg,"Action, Biography, Drama"
1520,The Accountant,1475,1502,-27,https://www.imdb.com/title/tt2140479/,https://raw.githubusercontent.com/eledah/imdb-delta/main/thumbnails/tt2140479.jpg,"Action, Crime, Drama"
1523,Rocketman,1748,1070,678,https://www.imdb.com/title/tt2066051/,https://raw.githubusercontent.com/eledah/imdb-delta/main/thumbnails/tt2066051.jpg,"Biography, Drama, Music"
1525,Flight,1452,1847,-395,https://www.imdb.com/title/tt1907668/,https://raw.githubusercontent.com/eledah/imdb-delta/main/thumbnails/tt1907668.jpg,"Drama, Thriller"
1526,The Edge of Seventeen,1486,1645,-159,https://www.imdb.com/title/tt1878870/,https://raw.githubusercontent.com/eledah/imdb-delta/main/thumbnails/tt1878870.jpg,"Comedy, Drama"
1527,Black Panther,1844,789,1055,https://www.imdb.com/title/tt1825683/,https://raw.githubusercontent.com/eledah/imdb-delta/main/thumbnails/tt1825683.jpg,"Action, Adventure, Sci-Fi"
1528,The Place Beyond the Pines,1412,1763,-351,https://www.imdb.com/title/tt1817273/,https://raw.githubusercontent.com/eledah/imdb-delta/main/thumbnails/tt1817273.jpg,"Crime, Drama, Thriller"
1530,Despicable Me 2,1637,1044,593,https://www.imdb.com/title/tt1690953/,https://raw.githubusercontent.com/eledah/imdb-delta/main/thumbnails/tt1690953.jpg,"Animation, Adventure, Comedy"
1531,Now You See Me,1777,1101,676,https://www.imdb.com/title/tt1670345/,https://raw.githubusercontent.com/eledah/imdb-delta/main/thumbnails/tt1670345.jpg,"Crime, Mystery, Thriller"
1532,The Man from U.N.C.L.E.,1681,1164,517,https://www.imdb.com/title/tt1638355/,https://raw.githubusercontent.com/eledah/imdb-delta/main/thumbnails/tt1638355.jpg,"Action, Adventure, Comedy"
1533,Fast Five,1580,1180,400,https://www.imdb.com/title/tt1596343/,https://raw.githubusercontent.com/eledah/imdb-delta/main/thumbnails/tt1596343.jpg,"Action, Crime, Thriller"
1535,The Next Three Days,1343,1595,-252,https://www.imdb.com/title/tt1458175/,https://raw.githubusercontent.com/eledah/imdb-delta/main/thumbnails/tt1458175.jpg,"Action, Crime, Drama"
1536,Monsters University,1713,1303,410,https://www.imdb.com/title/tt1453405/,https://raw.githubusercontent.com/eledah/imdb-delta/main/thumbnails/tt1453405.jpg,"Animation, Adventure, Comedy"
1537,Rise of the Guardians,1917,623,1294,https://www.imdb.com/title/tt1446192/,https://raw.githubusercontent.com/eledah/imdb-delta/main/thumbnails/tt1446192.jpg,"Animation, Action, Adventure"
1542,It,1484,1592,-108,https://www.imdb.com/title/tt1396484/,https://raw.githubusercontent.com/eledah/imdb-delta/main/thumbnails/tt1396484.jpg,"Fantasy, Horror"
1551,First Man,1584,1903,-319,https://www.imdb.com/title/tt1213641/,https://raw.githubusercontent.com/eledah/imdb-delta/main/thumbnails/tt1213641.jpg,"Biography, Drama, History"
1552,Lawless,1661,1444,217,https://www.imdb.com/title/tt1212450/,https://raw.githubusercontent.com/eledah/imdb-delta/main/thumbnails/tt1212450.jpg,"Biography, Crime, Drama"
1554,The Lincoln Lawyer,1466,1431,35,https://www.imdb.com/title/tt1189340/,https://raw.githubusercontent.com/eledah/imdb-delta/main/thumbnails/tt1189340.jpg,"Crime, Drama, Mystery"
1555,An Education,1710,1406,304,https://www.imdb.com/title/tt1174732/,https://raw.githubusercontent.com/eledah/imdb-delta/main/thumbnails/tt1174732.jpg,Drama
1557,Invictus,1505,1397,108,https://www.imdb.com/title/tt1057500/,https://raw.githubusercontent.com/eledah/imdb-delta/main/thumbnails/tt1057500.jpg,"Biography, Drama, History"
1558,The Descendants,1429,1833,-404,https://www.imdb.com/title/tt1033575/,https://raw.githubusercontent.com/eledah/imdb-delta/main/thumbnails/tt1033575.jpg,"Comedy, Drama"
1559,RocknRolla,1507,1427,80,https://www.imdb.com/title/tt1032755/,https://raw.githubusercontent.com/eledah/imdb-delta/main/thumbnails/tt1032755.jpg,"Action, Crime, Thriller"
1561,The Way Back,1516,1378,138,https://www.imdb.com/title/tt1023114/,https://raw.githubusercontent.com/eledah/imdb-delta/main/thumbnails/tt1023114.jpg,"Adventure, Drama, History"
1562,The Adventures of Tintin: The Secret of the Unicorn,1440,1750,-310,https://www.imdb.com/title/tt0983193/,https://raw.githubusercontent.com/eledah/imdb-delta/main/thumbnails/tt0983193.jpg,"Animation, Action, Adventure"
1564,Revolutionary Road,1556,1539,17,https://www.imdb.com/title/tt0959337/,https://raw.githubusercontent.com/eledah/imdb-delta/main/thumbnails/tt0959337.jpg,"Drama, Romance"
1565,Precious,1700,1218,482,https://www.imdb.com/title/tt0929632/,https://raw.githubusercontent.com/eledah/imdb-delta/main/thumbnails/tt0929632.jpg,Drama
1567,Lars and the Real Girl,1512,1297,215,https://www.imdb.com/title/tt0805564/,https://raw.githubusercontent.com/eledah/imdb-delta/main/thumbnails/tt0805564.jpg,"Comedy, Drama, Romance"
1569,Mr. Brooks,1397,1791,-394,https://www.imdb.com/title/tt0780571/,https://raw.githubusercontent.com/eledah/imdb-delta/main/thumbnails/tt0780571.jpg,"Crime, Drama, Mystery"
1570,Ant-Man,1627,1545,82,https://www.imdb.com/title/tt0478970/,https://raw.githubusercontent.com/eledah/imdb-delta/main/thumbnails/tt0478970.jpg,"Action, Comedy, Sci-Fi"
1572,The Simpsons Movie,1510,1871,-361,https://www.imdb.com/title/tt0462538/,https://raw.githubusercontent.com/eledah/imdb-delta/main/thumbnails/tt0462538.jpg,"Animation, Adventure, Comedy"
1573,Rescue Dawn,1560,1650,-90,https://www.imdb.com/title/tt0462504/,https://raw.githubusercontent.com/eledah/imdb-delta/main/thumbnails/tt0462504.jpg,"Adventure, Biography, War"
1574,Across the Universe,1738,997,741,https://www.imdb.com/title/tt0445922/,https://raw.githubusercontent.com/eledah/imdb-delta/main/thumbnails/tt0445922.jpg,"Drama, Fantasy, History"
1575,Borat: Cultural Learnings of America for Make Benefit Glorious Nation of Kazakhstan,1495,1998,-503,https://www.imdb.com/title/tt0443453/,https://raw.githubusercontent.com/eledah/imdb-delta/main/thumbnails/tt0443453.jpg,Comedy
1576,Lincoln,1414,1639,-225,https://www.imdb.com/title/tt0443272/,https://raw.githubusercontent.com/eledah/imdb-delta/main/thumbnails/tt0443272.jpg,"Biography, Drama, History"
1578,Alita: Battle Angel,1541,1754,-213,https://www.imdb.com/title/tt0437086/,https://raw.githubusercontent.com/eledah/imdb-delta/main/thumbnails/tt0437086.jpg,"Action, Adventure, Sci-Fi"
1579,The Queen,1602,1572,30,https://www.imdb.com/title/tt0436697/,https://raw.githubusercontent.com/eledah/imdb-delta/main/thumbnails/tt0436697.jpg,"Biography, Drama"
1580,Clerks II,1422,1922,-500,https://www.imdb.com/title/tt0424345/,https://raw.githubusercontent.com/eledah/imdb-delta/main/thumbnails/tt0424345.jpg,Comedy
1584,Sweeney Todd: The Demon Barber of Fleet Street,1712,1095,617,https://www.imdb.com/title/tt0408236/,https://raw.githubusercontent.com/eledah/imdb-delta/main/thumbnails/tt0408236.jpg,"Drama, Horror, Musical"
1587,Coach Carter,1583,1498,85,https://www.imdb.com/title/tt0393162/,https://raw.githubusercontent.com/eledah/imdb-delta/main/thumbnails/tt0393162.jpg,"Biography, Drama, Sport"
1588,Brick,1653,1902,-249,https://www.imdb.com/title/tt0393109/,https://raw.githubusercontent.com/eledah/imdb-delta/main/thumbnails/tt0393109.jpg,"Crime, Drama, Mystery"
1590,Pirates of the Caribbean: Dead Man's Chest,1589,1183,406,https://www.imdb.com/title/tt0383574/,https://raw.githubusercontent.com/eledah/imdb-delta/main/thumbnails/tt0383574.jpg,"Action, Adventure, Fantasy"
1591,Capote,1449,1352,97,https://www.imdb.com/title/tt0379725/,https://raw.githubusercontent.com/eledah/imdb-delta/main/thumbnails/tt0379725.jpg,"Biography, Crime, Drama"
1592,Layer Cake,1523,1937,-414,https://www.imdb.com/title/tt0375912/,https://raw.githubusercontent.com/eledah/imdb-delta/main/thumbnails/tt0375912.jpg,"Action, Crime, Drama"
1594,Dawn of the Dead,495,1226,-731,https://www.imdb.com/title/tt0363547/,https://raw.githubusercontent.com/eledah/imdb-delta/main/thumbnails/tt0363547.jpg,"Action, Horror"
1595,The Life Aquatic with Steve Zissou,1526,1713,-187,https://www.imdb.com/title/tt0362270/,https://raw.githubusercontent.com/eledah/imdb-delta/main/thumbnails/tt0362270.jpg,"Action, Adventure, Comedy"
1596,The Secret Life of Walter Mitty,1455,1425,30,https://www.imdb.com/title/tt0359950/,https://raw.githubusercontent.com/eledah/imdb-delta/main/thumbnails/tt0359950.jpg,"Adventure, Comedy, Drama"
1598,Monster,1660,1407,253,https://www.imdb.com/title/tt0340855/,https://raw.githubusercontent.com/eledah/imdb-delta/main/thumbnails/tt0340855.jpg,"Biography, Crime, Drama"
1599,Troy,1670,1863,-193,https://www.imdb.com/title/tt0332452/,https://raw.githubusercontent.com/eledah/imdb-delta/main/thumbnails/tt0332452.jpg,"Adventure, Drama"
1601,Matchstick Men,1596,1826,-230,https://www.imdb.com/title/tt0325805/,https://raw.githubusercontent.com/eledah/imdb-delta/main/thumbnails/tt0325805.jpg,"Comedy, Crime, Drama"
1602,Spider-Man 2,1529,1981,-452,https://www.imdb.com/title/tt0316654/,https://raw.githubusercontent.com/eledah/imdb-delta/main/thumbnails/tt0316654.jpg,"Action, Adventure, Sci-Fi"
1603,Identity,1554,1450,104,https://www.imdb.com/title/tt0309698/,https://raw.githubusercontent.com/eledah/imdb-delta/main/thumbnails/tt0309698.jpg,"Mystery, Thriller"
1610,Punch-Drunk Love,1550,1997,-447,https://www.imdb.com/title/tt0272338/,https://raw.githubusercontent.com/eledah/imdb-delta/main/thumbnails/tt0272338.jpg,"Comedy, Drama, Romance"
1611,Unbreakable,1511,1936,-425,https://www.imdb.com/title/tt0217869/,https://raw.githubusercontent.com/eledah/imdb-delta/main/thumbnails/tt0217869.jpg,"Drama, Mystery, Sci-Fi"
1613,Frequency,1501,1162,339,https://www.imdb.com/title/tt0186151/,https://raw.githubusercontent.com/eledah/imdb-delta/main/thumbnails/tt0186151.jpg,"Crime, Drama, Mystery"
1616,Galaxy Quest,1515,1161,354,https://www.imdb.com/title/tt0177789/,https://raw.githubusercontent.com/eledah/imdb-delta/main/thumbnails/tt0177789.jpg,"Adventure, Comedy, Sci-Fi"
1617,"Girl, Interrupted",1898,806,1092,https://www.imdb.com/title/tt0172493/,https://raw.githubusercontent.com/eledah/imdb-delta/main/thumbnails/tt0172493.jpg,"Biography, Drama"
1620,Sleepy Hollow,1517,1274,243,https://www.imdb.com/title/tt0162661/,https://raw.githubusercontent.com/eledah/imdb-delta/main/thumbnails/tt0162661.jpg,"Fantasy, Horror, Mystery"
1621,Ghost World,1521,1647,-126,https://www.imdb.com/title/tt0162346/,https://raw.githubusercontent.com/eledah/imdb-delta/main/thumbnails/tt0162346.jpg,"Comedy, Drama"
1622,10 Things I Hate About You,1985,856,1129,https://www.imdb.com/title/tt0147800/,https://raw.githubusercontent.com/eledah/imdb-delta/main/thumbnails/tt0147800.jpg,"Comedy, Drama, Romance"
1624,Spider-Man,1535,1906,-371,https://www.imdb.com/title/tt0145487/,https://raw.githubusercontent.com/eledah/imdb-delta/main/thumbnails/tt0145487.jpg,"Action, Adventure, Sci-Fi"
1625,Rounders,1379,1973,-594,https://www.imdb.com/title/tt0128442/,https://raw.githubusercontent.com/eledah/imdb-delta/main/thumbnails/tt0128442.jpg,"Crime, Drama"
1626,Ronin,1558,1964,-406,https://www.imdb.com/title/tt0122690/,https://raw.githubusercontent.com/eledah/imdb-delta/main/thumbnails/tt0122690.jpg,"Action, Crime, Thriller"
1627,Corpse Bride,1691,941,750,https://www.imdb.com/title/tt0121164/,https://raw.githubusercontent.com/eledah/imdb-delta/main/thumbnails/tt0121164.jpg,"Animation, Comedy, Drama"
1628,Tarzan,1800,1433,367,https://www.imdb.com/title/tt0120855/,https://raw.githubusercontent.com/eledah/imdb-delta/main/thumbnails/tt0120855.jpg,"Animation, Adventure, Comedy"
1629,The Negotiator,1569,1618,-49,https://www.imdb.com/title/tt0120768/,https://raw.githubusercontent.com/eledah/imdb-delta/main/thumbnails/tt0120768.jpg,"Action, Crime, Drama"
1631,Enemy of the State,1519,1721,-202,https://www.imdb.com/title/tt0120660/,https://raw.githubusercontent.com/eledah/imdb-delta/main/thumbnails/tt0120660.jpg,"Action, Thriller"
1632,Dogma,1617,1275,342,https://www.imdb.com/title/tt0120655/,https://raw.githubusercontent.com/eledah/imdb-delta/main/thumbnails/tt0120655.jpg,"Adventure, Comedy, Drama"
1633,Men in Black,1463,1666,-203,https://www.imdb.com/title/tt0119654/,https://raw.githubusercontent.com/eledah/imdb-delta/main/thumbnails/tt0119654.jpg,"Action, Adventure, Comedy"
1634,Hercules,1856,1159,697,https://www.imdb.com/title/tt0119282/,https://raw.githubusercontent.com/eledah/imdb-delta/main/thumbnails/tt0119282.jpg,"Animation, Action, Adventure"
1637,Scream,1695,1725,-30,https://www.imdb.com/title/tt0117571/,https://raw.githubusercontent.com/eledah/imdb-delta/main/thumbnails/tt0117571.jpg,"Horror, Mystery"
1639,Jerry Maguire,1543,1874,-331,https://www.imdb.com/title/tt0116695/,https://raw.githubusercontent.com/eledah/imdb-delta/main/thumbnails/tt0116695.jpg,"Comedy, Drama, Romance"
1643,Friday,1551,1587,-36,https://www.imdb.com/title/tt0113118/,https://raw.githubusercontent.com/eledah/imdb-delta/main/thumbnails/tt0113118.jpg,"Comedy, Drama"
1644,Crimson Tide,1493,1786,-293,https://www.imdb.com/title/tt0112740/,https://raw.githubusercontent.com/eledah/imdb-delta/main/thumbnails/tt0112740.jpg,"Action, Drama, Thriller"
1645,The Basketball Diaries,1524,1316,208,https://www.imdb.com/title/tt0112461/,https://raw.githubusercontent.com/eledah/imdb-delta/main/thumbnails/tt0112461.jpg,"Biography, Crime, Drama"
1647,Natural Born Killers,1598,1206,392,https://www.imdb.com/title/tt0110632/,https://raw.githubusercontent.com/eledah/imdb-delta/main/thumbnails/tt0110632.jpg,"Action, Crime, Romance"
1651,Dumb and Dumber,1335,1999,-664,https://www.imdb.com/title/tt0109686/,https://raw.githubusercontent.com/eledah/imdb-delta/main/thumbnails/tt0109686.jpg,Comedy
1659,Point Break,1566,1719,-153,https://www.imdb.com/title/tt0102685/,https://raw.githubusercontent.com/eledah/imdb-delta/main/thumbnails/tt0102685.jpg,"Action, Crime, Thriller"
1660,Cape Fear,713,700,13,https://www.imdb.com/title/tt0101540/,https://raw.githubusercontent.com/eledah/imdb-delta/main/thumbnails/tt0101540.jpg,"Crime, Thriller"
1665,Driving Miss Daisy,1444,1217,227,https://www.imdb.com/title/tt0097239/,https://raw.githubusercontent.com/eledah/imdb-delta/main/thumbnails/tt0097239.jpg,"Comedy, Drama"
1666,Willow,1682,1136,546,https://www.imdb.com/title/tt0096446/,https://raw.githubusercontent.com/eledah/imdb-delta/main/thumbnails/tt0096446.jpg,"Action, Adventure, Drama"
1668,They Live,1568,1793,-225,https://www.imdb.com/title/tt0096256/,https://raw.githubusercontent.com/eledah/imdb-delta/main/thumbnails/tt0096256.jpg,"Action, Horror, Sci-Fi"
1670,Big,1480,1553,-73,https://www.imdb.com/title/tt0094737/,https://raw.githubusercontent.com/eledah/imdb-delta/main/thumbnails/tt0094737.jpg,"Comedy, Drama, Fantasy"
1671,Raising Arizona,1393,1726,-333,https://www.imdb.com/title/tt0093822/,https://raw.githubusercontent.com/eledah/imdb-delta/main/thumbnails/tt0093822.jpg,"Comedy, Crime"
1672,The Lost Boys,1835,1112,723,https://www.imdb.com/title/tt0093437/,https://raw.githubusercontent.com/eledah/imdb-delta/main/thumbnails/tt0093437.jpg,"Comedy, Horror"
1673,"Good Morning, Vietnam",1443,1386,57,https://www.imdb.com/title/tt0093105/,https://raw.githubusercontent.com/eledah/imdb-delta/main/thumbnails/tt0093105.jpg,"Biography, Comedy, Drama"
1678,Big Trouble in Little China,1546,1888,-342,https://www.imdb.com/title/tt0090728/,https://raw.githubusercontent.com/eledah/imdb-delta/main/thumbnails/tt0090728.jpg,"Action, Adventure, Comedy"
1683,The Karate Kid,1651,1739,-88,https://www.imdb.com/title/tt0087538/,https://raw.githubusercontent.com/eledah/imdb-delta/main/thumbnails/tt0087538.jpg,"Action, Drama, Family"
1684,Gremlins,1572,1800,-228,https://www.imdb.com/title/tt0087363/,https://raw.githubusercontent.com/eledah/imdb-delta/main/thumbnails/tt0087363.jpg,"Comedy, Fantasy, Horror"
1685,Beverly Hills Cop,1461,1865,-404,https://www.imdb.com/title/tt0086960/,https://raw.githubusercontent.com/eledah/imdb-delta/main/thumbnails/tt0086960.jpg,"Action, Comedy, Crime"
1686,Poltergeist,1399,1570,-171,https://www.imdb.com/title/tt0084516/,https://raw.githubusercontent.com/eledah/imdb-delta/main/thumbnails/tt0084516.jpg,"Horror, Thriller"
1689,Caddyshack,1539,1948,-409,https://www.imdb.com/title/tt0080487/,https://raw.githubusercontent.com/eledah/imdb-delta/main/thumbnails/tt0080487.jpg,"Comedy, Sport"
1690,Rocky II,1685,1917,-232,https://www.imdb.com/title/tt0079817/,https://raw.githubusercontent.com/eledah/imdb-delta/main/thumbnails/tt0079817.jpg,"Drama, Sport"
1691,Superman,1419,1611,-192,https://www.imdb.com/title/tt0078346/,https://raw.githubusercontent.com/eledah/imdb-delta/main/thumbnails/tt0078346.jpg,"Action, Adventure, Sci-Fi"
1698,Easy Rider,1506,1768,-262,https://www.imdb.com/title/tt0064276/,https://raw.githubusercontent.com/eledah/imdb-delta/main/thumbnails/tt0064276.jpg,"Adventure, Drama"
1700,One Hundred and One Dalmatians,1864,1169,695,https://www.imdb.com/title/tt0055254/,https://raw.githubusercontent.com/eledah/imdb-delta/main/thumbnails/tt0055254.jpg,"Animation, Adventure, Comedy"
1701,Lady and the Tramp,1847,954,893,https://www.imdb.com/title/tt0048280/,https://raw.githubusercontent.com/eledah/imdb-delta/main/thumbnails/tt0048280.jpg,"Animation, Adventure, Comedy"
1702,Peter Pan,1709,1177,532,https://www.imdb.com/title/tt0046183/,https://raw.githubusercontent.com/eledah/imdb-delta/main/thumbnails/tt0046183.jpg,"Animation, Adventure, Family"
1703,Cinderella,1957,934,1023,https://www.imdb.com/title/tt0042332/,https://raw.githubusercontent.com/eledah/imdb-delta/main/thumbnails/tt0042332.jpg,"Animation, Family, Fantasy"
1704,Bambi,1610,1394,216,https://www.imdb.com/title/tt0034492/,https://raw.githubusercontent.com/eledah/imdb-delta/main/thumbnails/tt0034492.jpg,"Animation, Adventure, Drama"
1708,The Post,1858,1814,44,https://www.imdb.com/title/tt6294822/,https://raw.githubusercontent.com/eledah/imdb-delta/main/thumbnails/tt6294822.jpg,"Biography, Drama, History"
1709,Vice,1783,1728,55,https://www.imdb.com/title/tt6266538/,https://raw.githubusercontent.com/eledah/imdb-delta/main/thumbnails/tt6266538.jpg,"Biography, Comedy, Drama"
1715,The Founder,1680,1919,-239,https://www.imdb.com/title/tt4276820/,https://raw.githubusercontent.com/eledah/imdb-delta/main/thumbnails/tt4276820.jpg,"Biography, Drama"
1721,American Made,1852,1932,-80,https://www.imdb.com/title/tt3532216/,https://raw.githubusercontent.com/eledah/imdb-delta/main/thumbnails/tt3532216.jpg,"Action, Comedy, Crime"
1722,The Lobster,1910,1873,37,https://www.imdb.com/title/tt3464902/,https://raw.githubusercontent.com/eledah/imdb-delta/main/thumbnails/tt3464902.jpg,"Drama, Romance, Sci-Fi"
1725,Coherence,1725,1705,20,https://www.imdb.com/title/tt2866360/,https://raw.githubusercontent.com/eledah/imdb-delta/main/thumbnails/tt2866360.jpg,"Drama, Mystery, Sci-Fi"
1726,T2 Trainspotting,1827,1655,172,https://www.imdb.com/title/tt2763304/,https://raw.githubusercontent.com/eledah/imdb-delta/main/thumbnails/tt2763304.jpg,"Comedy, Crime, Drama"
1733,Carol,1720,1758,-38,https://www.imdb.com/title/tt2402927/,https://raw.githubusercontent.com/eledah/imdb-delta/main/thumbnails/tt2402927.jpg,"Drama, Romance"
1740,Steve Jobs,1765,1979,-214,https://www.imdb.com/title/tt2080374/,https://raw.githubusercontent.com/eledah/imdb-delta/main/thumbnails/tt2080374.jpg,"Biography, Drama"
1741,Seven Psychopaths,1830,1704,126,https://www.imdb.com/title/tt1931533/,https://raw.githubusercontent.com/eledah/imdb-delta/main/thumbnails/tt1931533.jpg,"Comedy, Crime"
1745,Unbroken,1918,1149,769,https://www.imdb.com/title/tt1809398/,https://raw.githubusercontent.com/eledah/imdb-delta/main/thumbnails/tt1809398.jpg,"Action, Biography, Drama"
1746,American Hustle,1605,1921,-316,https://www.imdb.com/title/tt1800241/,https://raw.githubusercontent.com/eledah/imdb-delta/main/thumbnails/tt1800241.jpg,"Crime, Drama"
1749,Shame,1656,1933,-277,https://www.imdb.com/title/tt1723811/,https://raw.githubusercontent.com/eledah/imdb-delta/main/thumbnails/tt1723811.jpg,Drama
1750,Carnage,1781,1875,-94,https://www.imdb.com/title/tt1692486/,https://raw.githubusercontent.com/eledah/imdb-delta/main/thumbnails/tt1692486.jpg,"Comedy, Drama"
1751,The Age of Adaline,1848,1470,378,https://www.imdb.com/title/tt1655441/,https://raw.githubusercontent.com/eledah/imdb-delta/main/thumbnails/tt1655441.jpg,"Drama, Fantasy, Romance"
1752,"Love, Rosie",1991,1541,450,https://www.imdb.com/title/tt1638002/,https://raw.githubusercontent.com/eledah/imdb-delta/main/thumbnails/tt1638002.jpg,"Comedy, Romance"
1755,War Horse,1812,1118,694,https://www.imdb.com/title/tt1568911/,https://raw.githubusercontent.com/eledah/imdb-delta/main/thumbnails/tt1568911.jpg,"Action, Adventure, Drama"
1756,The Master,1808,1987,-179,https://www.imdb.com/title/tt1560747/,https://raw.githubusercontent.com/eledah/imdb-delta/main/thumbnails/tt1560747.jpg,"Drama, History"
1758,Melancholia,1906,1808,98,https://www.imdb.com/title/tt1527186/,https://raw.githubusercontent.com/eledah/imdb-delta/main/thumbnails/tt1527186.jpg,"Drama, Sci-Fi"
1761,The Hunger Games,1944,651,1293,https://www.imdb.com/title/tt1392170/,https://raw.githubusercontent.com/eledah/imdb-delta/main/thumbnails/tt1392170.jpg,"Action, Adventure, Sci-Fi"
1762,The Great Gatsby,1809,1266,543,https://www.imdb.com/title/tt1343092/,https://raw.githubusercontent.com/eledah/imdb-delta/main/thumbnails/tt1343092.jpg,"Drama, Romance"
1763,Lee Daniels' The Butler,1963,1295,668,https://www.imdb.com/title/tt1327773/,https://raw.githubusercontent.com/eledah/imdb-delta/main/thumbnails/tt1327773.jpg,"Biography, Drama"
1765,Kung Fu Panda 2,1626,1790,-164,https://www.imdb.com/title/tt1302011/,https://raw.githubusercontent.com/eledah/imdb-delta/main/thumbnails/tt1302011.jpg,"Animation, Action, Adventure"
1769,21 Jump Street,1775,1723,52,https://www.imdb.com/title/tt1232829/,https://raw.githubusercontent.com/eledah/imdb-delta/main/thumbnails/tt1232829.jpg,"Action, Comedy, Crime"
1771,Rango,1642,1972,-330,https://www.imdb.com/title/tt1192628/,https://raw.githubusercontent.com/eledah/imdb-delta/main/thumbnails/tt1192628.jpg,"Animation, Action, Adventure"
1775,10 Cloverfield Lane,1645,1929,-284,https://www.imdb.com/title/tt1179933/,https://raw.githubusercontent.com/eledah/imdb-delta/main/thumbnails/tt1179933.jpg,"Drama, Horror, Mystery"
1777,The Ghost Writer,1718,1879,-161,https://www.imdb.com/title/tt1139328/,https://raw.githubusercontent.com/eledah/imdb-delta/main/thumbnails/tt1139328.jpg,"Crime, Drama, Mystery"
1778,Paddington,1798,1512,286,https://www.imdb.com/title/tt1109624/,https://raw.githubusercontent.com/eledah/imdb-delta/main/thumbnails/tt1109624.jpg,"Adventure, Comedy, Family"
1780,Defiance,1871,1544,327,https://www.imdb.com/title/tt1034303/,https://raw.githubusercontent.com/eledah/imdb-delta/main/thumbnails/tt1034303.jpg,"Action, Drama, History"
1782,Megamind,1703,1526,177,https://www.imdb.com/title/tt1001526/,https://raw.githubusercontent.com/eledah/imdb-delta/main/thumbnails/tt1001526.jpg,"Animation, Action, Adventure"
1784,The Road,1687,1872,-185,https://www.imdb.com/title/tt0898367/,https://raw.githubusercontent.com/eledah/imdb-delta/main/thumbnails/tt0898367.jpg,"Drama, Thriller"
1786,The Darjeeling Limited,1790,1446,344,https://www.imdb.com/title/tt0838221/,https://raw.githubusercontent.com/eledah/imdb-delta/main/thumbnails/tt0838221.jpg,"Adventure, Comedy, Drama"
1787,Shooter,1863,1824,39,https://www.imdb.com/title/tt0822854/,https://raw.githubusercontent.com/eledah/imdb-delta/main/thumbnails/tt0822854.jpg,"Action, Drama, Thriller"
1789,Silence,1839,1967,-128,https://www.imdb.com/title/tt0490215/,https://raw.githubusercontent.com/eledah/imdb-delta/main/thumbnails/tt0490215.jpg,"Drama, History"
1790,Fracture,1740,1430,310,https://www.imdb.com/title/tt0488120/,https://raw.githubusercontent.com/eledah/imdb-delta/main/thumbnails/tt0488120.jpg,"Crime, Drama, Thriller"
1791,The Croods,1883,1400,483,https://www.imdb.com/title/tt0481499/,https://raw.githubusercontent.com/eledah/imdb-delta/main/thumbnails/tt0481499.jpg,"Animation, Adventure, Comedy"
1793,I Am Legend,1850,1844,6,https://www.imdb.com/title/tt0480249/,https://raw.githubusercontent.com/eledah/imdb-delta/main/thumbnails/tt0480249.jpg,"Action, Drama, Horror"
1797,Michael Clayton,1693,1900,-207,https://www.imdb.com/title/tt0465538/,https://raw.githubusercontent.com/eledah/imdb-delta/main/thumbnails/tt0465538.jpg,"Crime, Drama, Mystery"
1800,The Equalizer,1707,1715,-8,https://www.imdb.com/title/tt0455944/,https://raw.githubusercontent.com/eledah/imdb-delta/main/thumbnails/tt0455944.jpg,"Action, Crime, Thriller"
1801,Sunshine,1618,1828,-210,https://www.imdb.com/title/tt0448134/,https://raw.githubusercontent.com/eledah/imdb-delta/main/thumbnails/tt0448134.jpg,"Sci-Fi, Thriller"
1803,The Descent,1780,1892,-112,https://www.imdb.com/title/tt0435625/,https://raw.githubusercontent.com/eledah/imdb-delta/main/thumbnails/tt0435625.jpg,"Adventure, Horror, Thriller"
1806,The Fountain,1726,1734,-8,https://www.imdb.com/title/tt0414993/,https://raw.githubusercontent.com/eledah/imdb-delta/main/thumbnails/tt0414993.jpg,"Drama, Mystery, Romance"
1814,Closer,1662,1730,-68,https://www.imdb.com/title/tt0376541/,https://raw.githubusercontent.com/eledah/imdb-delta/main/thumbnails/tt0376541.jpg,"Drama, Romance"
1815,Team America: World Police,1805,1992,-187,https://www.imdb.com/title/tt0372588/,https://raw.githubusercontent.com/eledah/imdb-delta/main/thumbnails/tt0372588.jpg,"Action, Comedy"
1820,King Kong,500,1292,-792,https://www.imdb.com/title/tt0360717/,https://raw.githubusercontent.com/eledah/imdb-delta/main/thumbnails/tt0360717.jpg,"Action, Adventure, Romance"
1821,Anchorman: The Legend of Ron Burgundy,1677,1985,-308,https://www.imdb.com/title/tt0357413/,https://raw.githubusercontent.com/eledah/imdb-delta/main/thumbnails/tt0357413.jpg,Comedy
1823,The Passion of the Christ,1932,1624,308,https://www.imdb.com/title/tt0335345/,https://raw.githubusercontent.com/eledah/imdb-delta/main/thumbnails/tt0335345.jpg,Drama
1825,Kingdom of Heaven,1650,1947,-297,https://www.imdb.com/title/tt0320661/,https://raw.githubusercontent.com/eledah/imdb-delta/main/thumbnails/tt0320661.jpg,"Action, Adventure, Drama"
1827,The Dreamers,1897,1469,428,https://www.imdb.com/title/tt0309987/,https://raw.githubusercontent.com/eledah/imdb-delta/main/thumbnails/tt0309987.jpg,"Drama, Romance"
1828,Chicago,1981,1332,649,https://www.imdb.com/title/tt0299658/,https://raw.githubusercontent.com/eledah/imdb-delta/main/thumbnails/tt0299658.jpg,"Comedy, Crime, Musical"
1829,Shrek 2,1807,1575,232,https://www.imdb.com/title/tt0298148/,https://raw.githubusercontent.com/eledah/imdb-delta/main/thumbnails/tt0298148.jpg,"Animation, Adventure, Comedy"
1830,The Phantom of the Opera,1989,933,1056,https://www.imdb.com/title/tt0293508/,https://raw.githubusercontent.com/eledah/imdb-delta/main/thumbnails/tt0293508.jpg,"Drama, Musical, Romance"
1831,Red Dragon,1731,1561,170,https://www.imdb.com/title/tt0289765/,https://raw.githubusercontent.com/eledah/imdb-delta/main/thumbnails/tt0289765.jpg,"Crime, Drama, Thriller"
1833,Insomnia,1724,1960,-236,https://www.imdb.com/title/tt0278504/,https://raw.githubusercontent.com/eledah/imdb-delta/main/thumbnails/tt0278504.jpg,"Drama, Mystery, Thriller"
1834,We Were Soldiers,1826,1858,-32,https://www.imdb.com/title/tt0277434/,https://raw.githubusercontent.com/eledah/imdb-delta/main/thumbnails/tt0277434.jpg,"Action, Drama, History"
1835,Lilo & Stitch,1951,1234,717,https://www.imdb.com/title/tt0275847/,https://raw.githubusercontent.com/eledah/imdb-delta/main/thumbnails/tt0275847.jpg,"Animation, Adventure, Comedy"
1837,Chocolat,1885,1158,727,https://www.imdb.com/title/tt0241303/,https://raw.githubusercontent.com/eledah/imdb-delta/main/thumbnails/tt0241303.jpg,"Drama, Romance"
1839,The Matrix Reloaded,1762,1920,-158,https://www.imdb.com/title/tt0234215/,https://raw.githubusercontent.com/eledah/imdb-delta/main/thumbnails/tt0234215.jpg,"Action, Sci-Fi"
1840,Pay It Forward,1927,1197,730,https://www.imdb.com/title/tt0223897/,https://raw.githubusercontent.com/eledah/imdb-delta/main/thumbnails/tt0223897.jpg,Drama
1842,A.I. Artificial Intelligence,1890,1688,202,https://www.imdb.com/title/tt0212720/,https://raw.githubusercontent.com/eledah/imdb-delta/main/thumbnails/tt0212720.jpg,"Adventure, Drama, Sci-Fi"
1843,Men of Honor,1756,1213,543,https://www.imdb.com/title/tt0203019/,https://raw.githubusercontent.com/eledah/imdb-delta/main/thumbnails/tt0203019.jpg,"Biography, Drama"
1844,The Bank Job,1705,1925,-220,https://www.imdb.com/title/tt0200465/,https://raw.githubusercontent.com/eledah/imdb-delta/main/thumbnails/tt0200465.jpg,"Crime, Drama, Thriller"
1845,The Patriot,1870,1692,178,https://www.imdb.com/title/tt0187393/,https://raw.githubusercontent.com/eledah/imdb-delta/main/thumbnails/tt0187393.jpg,"Action, Drama, History"
1849,Cold Mountain,1882,1566,316,https://www.imdb.com/title/tt0159365/,https://raw.githubusercontent.com/eledah/imdb-delta/main/thumbnails/tt0159365.jpg,"Adventure, Drama, Romance"
1850,The Virgin Suicides,1828,1676,152,https://www.imdb.com/title/tt0159097/,https://raw.githubusercontent.com/eledah/imdb-delta/main/thumbnails/tt0159097.jpg,"Drama, Romance"
1854,Treasure Planet,1969,1528,441,https://www.imdb.com/title/tt0133240/,https://raw.githubusercontent.com/eledah/imdb-delta/main/thumbnails/tt0133240.jpg,"Animation, Adventure, Family"
1856,Cube,1667,1859,-192,https://www.imdb.com/title/tt0123755/,https://raw.githubusercontent.com/eledah/imdb-delta/main/thumbnails/tt0123755.jpg,"Horror, Mystery, Sci-Fi"
1859,A Bug's Life,1806,1807,-1,https://www.imdb.com/title/tt0120623/,https://raw.githubusercontent.com/eledah/imdb-delta/main/thumbnails/tt0120623.jpg,"Animation, Adventure, Comedy"
1860,Starship Troopers,1564,1991,-427,https://www.imdb.com/title/tt0120201/,https://raw.githubusercontent.com/eledah/imdb-delta/main/thumbnails/tt0120201.jpg,"Action, Adventure, Sci-Fi"
1862,Meet Joe Black,1842,1699,143,https://www.imdb.com/title/tt0119643/,https://raw.githubusercontent.com/eledah/imdb-delta/main/thumbnails/tt0119643.jpg,"Drama, Fantasy, Romance"
1865,Face/Off,1613,1820,-207,https://www.imdb.com/title/tt0119094/,https://raw.githubusercontent.com/eledah/imdb-delta/main/thumbnails/tt0119094.jpg,"Action, Crime, Sci-Fi"
1866,Chasing Amy,1606,1984,-378,https://www.imdb.com/title/tt0118842/,https://raw.githubusercontent.com/eledah/imdb-delta/main/thumbnails/tt0118842.jpg,"Comedy, Drama, Romance"
1867,Anastasia,2000,810,1190,https://www.imdb.com/title/tt0118617/,https://raw.githubusercontent.com/eledah/imdb-delta/main/thumbnails/tt0118617.jpg,"Animation, Adventure, Drama"
1869,Mission: Impossible,1814,1968,-154,https://www.imdb.com/title/tt0117060/,https://raw.githubusercontent.com/eledah/imdb-delta/main/thumbnails/tt0117060.jpg,"Action, Adventure, Thriller"
1871,From Dusk Till Dawn,1614,1821,-207,https://www.imdb.com/title/tt0116367/,https://raw.githubusercontent.com/eledah/imdb-delta/main/thumbnails/tt0116367.jpg,"Action, Crime, Horror"
1874,GoldenEye,1787,1983,-196,https://www.imdb.com/title/tt0113189/,https://raw.githubusercontent.com/eledah/imdb-delta/main/thumbnails/tt0113189.jpg,"Action, Adventure, Thriller"
1875,Desperado,1820,1864,-44,https://www.imdb.com/title/tt0112851/,https://raw.githubusercontent.com/eledah/imdb-delta/main/thumbnails/tt0112851.jpg,"Action, Crime, Drama"
1876,True Lies,1686,1809,-123,https://www.imdb.com/title/tt0111503/,https://raw.githubusercontent.com/eledah/imdb-delta/main/thumbnails/tt0111503.jpg,"Action, Comedy, Thriller"
1877,Speed,1704,1694,10,https://www.imdb.com/title/tt0111257/,https://raw.githubusercontent.com/eledah/imdb-delta/main/thumbnails/tt0111257.jpg,"Action, Adventure, Thriller"
1891,Die Hard 2,1815,1935,-120,https://www.imdb.com/title/tt0099423/,https://raw.githubusercontent.com/eledah/imdb-delta/main/thumbnails/tt0099423.jpg,"Action, Thriller"
1894,Lethal Weapon 2,1683,1848,-165,https://www.imdb.com/title/tt0097733/,https://raw.githubusercontent.com/eledah/imdb-delta/main/thumbnails/tt0097733.jpg,"Action, Crime, Thriller"
1916,Escape from New York,1838,1949,-111,https://www.imdb.com/title/tt0082340/,https://raw.githubusercontent.com/eledah/imdb-delta/main/thumbnails/tt0082340.jpg,"Action, Adventure, Sci-Fi"
1921,Grease,1975,1012,963,https://www.imdb.com/title/tt0077631/,https://raw.githubusercontent.com/eledah/imdb-delta/main/thumbnails/tt0077631.jpg,"Comedy, Musical, Romance"
1925,Mean Streets,1646,1853,-207,https://www.imdb.com/title/tt0070379/,https://raw.githubusercontent.com/eledah/imdb-delta/main/thumbnails/tt0070379.jpg,"Crime, Drama, Thriller"
1935,Dr. No,1640,1899,-259,https://www.imdb.com/title/tt0055928/,https://raw.githubusercontent.com/eledah/imdb-delta/main/thumbnails/tt0055928.jpg,"Action, Adventure, Thriller"
1936,Sleeping Beauty,1904,1121,783,https://www.imdb.com/title/tt0053285/,https://raw.githubusercontent.com/eledah/imdb-delta/main/thumbnails/tt0053285.jpg,"Animation, Adventure, Family"
1940,Dumbo,1759,1597,162,https://www.imdb.com/title/tt0033563/,https://raw.githubusercontent.com/eledah/imdb-delta/main/thumbnails/tt0033563.jpg,"Animation, Adventure, Drama"
1943,Midsommar,1953,1954,-1,https://www.imdb.com/title/tt8772262/,https://raw.githubusercontent.com/eledah/imdb-delta/main/thumbnails/tt8772262.jpg,"Drama, Horror, Mystery"
1946,The Devil All the Time,1967,1898,69,https://www.imdb.com/title/tt7395114/,https://raw.githubusercontent.com/eledah/imdb-delta/main/thumbnails/tt7395114.jpg,"Crime, Drama, Thriller"
1949,Bad Times at the El Royale,1930,1883,47,https://www.imdb.com/title/tt6628394/,https://raw.githubusercontent.com/eledah/imdb-delta/main/thumbnails/tt6628394.jpg,"Crime, Drama, Mystery"
1952,Creed II,1948,1733,215,https://www.imdb.com/title/tt6343314/,https://raw.githubusercontent.com/eledah/imdb-delta/main/thumbnails/tt6343314.jpg,"Action, Drama, Sport"
1955,Sicario: Day of the Soldado,1960,1955,5,https://www.imdb.com/title/tt5052474/,https://raw.githubusercontent.com/eledah/imdb-delta/main/thumbnails/tt5052474.jpg,"Action, Crime, Drama"
1960,Don't Breathe,1912,1956,-44,https://www.imdb.com/title/tt4160708/,https://raw.githubusercontent.com/eledah/imdb-delta/main/thumbnails/tt4160708.jpg,"Crime, Horror, Thriller"
1967,Allied,1880,1915,-35,https://www.imdb.com/title/tt3640424/,https://raw.githubusercontent.com/eledah/imdb-delta/main/thumbnails/tt3640424.jpg,"Action, Drama, Romance"
1970,Sing,1947,1619,328,https://www.imdb.com/title/tt3470600/,https://raw.githubusercontent.com/eledah/imdb-delta/main/thumbnails/tt3470600.jpg,"Animation, Comedy, Family"
1976,Furious 7,1961,1108,853,https://www.imdb.com/title/tt2820852/,https://raw.githubusercontent.com/eledah/imdb-delta/main/thumbnails/tt2820852.jpg,"Action, Crime, Thriller"
1978,Beauty and the Beast,635,40,595,https://www.imdb.com/title/tt2771200/,https://raw.githubusercontent.com/eledah/imdb-delta/main/thumbnails/tt2771200.jpg,"Adventure, Family, Fantasy"
1981,Everest,1970,1825,145,https://www.imdb.com/title/tt2719848/,https://raw.githubusercontent.com/eledah/imdb-delta/main/thumbnails/tt2719848.jpg,"Action, Adventure, Biography"
1982,Locke,1902,1913,-11,https://www.imdb.com/title/tt2692904/,https://raw.githubusercontent.com/eledah/imdb-delta/main/thumbnails/tt2692904.jpg,Drama
1983,Star Trek Beyond,1984,1535,449,https://www.imdb.com/title/tt2660888/,https://raw.githubusercontent.com/eledah/imdb-delta/main/thumbnails/tt2660888.jpg,"Action, Adventure, Sci-Fi"
1986,The Intern,1923,1613,310,https://www.imdb.com/title/tt2361509/,https://raw.githubusercontent.com/eledah/imdb-delta/main/thumbnails/tt2361509.jpg,"Comedy, Drama"
1988,Wild,1937,1548,389,https://www.imdb.com/title/tt2305051/,https://raw.githubusercontent.com/eledah/imdb-delta/main/thumbnails/tt2305051.jpg,"Adventure, Biography, Drama"
1990,Kung Fu Panda 3,1939,1680,259,https://www.imdb.com/title/tt2267968/,https://raw.githubusercontent.com/eledah/imdb-delta/main/thumbnails/tt2267968.jpg,"Animation, Action, Adventure"
1997,Side Effects,1919,1940,-21,https://www.imdb.com/title/tt2053463/,https://raw.githubusercontent.com/eledah/imdb-delta/main/thumbnails/tt2053463.jpg,"Crime, Drama, Mystery"
1998,War Dogs,1894,1938,-44,https://www.imdb.com/title/tt2005151/,https://raw.githubusercontent.com/eledah/imdb-delta/main/thumbnails/tt2005151.jpg,"Biography, Comedy, Crime"
2000,Pitch Perfect,1983,1383,600,https://www.imdb.com/title/tt1981677/,https://raw.githubusercontent.com/eledah/imdb-delta/main/thumbnails/tt1981677.jpg,"Comedy, Music, Romance"
