ID,Name,Male,Female,Delta,Link
2,The Shawshank Redemption,1,3,-2,https://www.imdb.com/title/tt0111161/
3,The Godfather,3,7,-4,https://www.imdb.com/title/tt0068646/
4,The Dark Knight,5,17,-12,https://www.imdb.com/title/tt0468569/
5,The Godfather: Part II,4,14,-10,https://www.imdb.com/title/tt0071562/
6,12 Angry Men,8,10,-2,https://www.imdb.com/title/tt0050083/
7,The Lord of the Rings: The Return of the King,7,8,-1,https://www.imdb.com/title/tt0167260/
8,Pulp Fiction,6,38,-32,https://www.imdb.com/title/tt0110912/
9,Schindler's List,9,5,4,https://www.imdb.com/title/tt0108052/
10,The Mountain II,13,6,7,https://www.imdb.com/title/tt5813916/
11,Inception,14,24,-10,https://www.imdb.com/title/tt1375666/
12,Fight Club,11,19,-8,https://www.imdb.com/title/tt0137523/
13,The Lord of the Rings: The Fellowship of the Ring,12,12,0,https://www.imdb.com/title/tt0120737/
14,Forrest Gump,15,18,-3,https://www.imdb.com/title/tt0109830/
15,"The Good, the Bad and the Ugly",10,76,-66,https://www.imdb.com/title/tt0060196/
16,The Lord of the Rings: The Two Towers,17,20,-3,https://www.imdb.com/title/tt0167261/
17,The Matrix,18,113,-95,https://www.imdb.com/title/tt0133093/
18,Goodfellas,21,102,-81,https://www.imdb.com/title/tt0099685/
19,Star Wars: Episode V - The Empire Strikes Back,16,57,-41,https://www.imdb.com/title/tt0080684/
20,One Flew Over the Cuckoo's Nest,20,28,-8,https://www.imdb.com/title/tt0073486/
21,Parasite,46,37,9,https://www.imdb.com/title/tt6751668/
23,Interstellar,25,79,-54,https://www.imdb.com/title/tt0816692/
24,City of God,23,71,-48,https://www.imdb.com/title/tt0317248/
25,Spirited Away,43,13,30,https://www.imdb.com/title/tt0245429/
26,Saving Private Ryan,28,282,-254,https://www.imdb.com/title/tt0120815/
27,The Green Mile,42,21,21,https://www.imdb.com/title/tt0120689/
28,Life Is Beautiful,36,9,27,https://www.imdb.com/title/tt0118799/
29,Se7en,22,44,-22,https://www.imdb.com/title/tt0114369/
30,The Silence of the Lambs,30,33,-3,https://www.imdb.com/title/tt0102926/
31,Star Wars: Episode IV - A New Hope,26,58,-32,https://www.imdb.com/title/tt0076759/
33,Seven Samurai,19,109,-90,https://www.imdb.com/title/tt0047478/
34,It's a Wonderful Life,24,32,-8,https://www.imdb.com/title/tt0038650/
37,Whiplash,52,97,-45,https://www.imdb.com/title/tt2582802/
38,The Intouchables,49,15,34,https://www.imdb.com/title/tt1675434/
39,The Prestige,40,84,-44,https://www.imdb.com/title/tt0482571/
40,The Departed,47,105,-58,https://www.imdb.com/title/tt0407887/
41,The Pianist,50,23,27,https://www.imdb.com/title/tt0253474/
42,Gladiator,33,139,-106,https://www.imdb.com/title/tt0172495/
43,American History X,53,29,24,https://www.imdb.com/title/tt0120586/
44,The Usual Suspects,32,68,-36,https://www.imdb.com/title/tt0114814/
45,Léon: The Professional,34,25,9,https://www.imdb.com/title/tt0110413/
46,The Lion King,69,11,58,https://www.imdb.com/title/tt0110357/
47,Terminator 2: Judgment Day,31,317,-286,https://www.imdb.com/title/tt0103064/
48,Cinema Paradiso,58,36,22,https://www.imdb.com/title/tt0095765/
49,Grave of the Fireflies,59,26,33,https://www.imdb.com/title/tt0095327/
50,Back to the Future,35,85,-50,https://www.imdb.com/title/tt0088763/
51,Once Upon a Time in the West,48,299,-251,https://www.imdb.com/title/tt0064116/
52,Psycho,41,59,-18,https://www.imdb.com/title/tt0054215/
53,Casablanca,38,95,-57,https://www.imdb.com/title/tt0034583/
54,Modern Times,37,51,-14,https://www.imdb.com/title/tt0027977/
55,City Lights,39,43,-4,https://www.imdb.com/title/tt0021749/
57,Joker,73,50,23,https://www.imdb.com/title/tt7286456/
60,Your Name.,79,92,-13,https://www.imdb.com/title/tt5311514/
61,Dangal,81,56,25,https://www.imdb.com/title/tt5074352/
62,Spider-Man: Into the Spider-Verse,112,49,63,https://www.imdb.com/title/tt4633694/
63,Avengers: Endgame,110,41,69,https://www.imdb.com/title/tt4154796/
64,Avengers: Infinity War,68,78,-10,https://www.imdb.com/title/tt4154756/
66,Coco,106,31,75,https://www.imdb.com/title/tt2380307/
67,Django Unchained,55,90,-35,https://www.imdb.com/title/tt1853728/
68,The Dark Knight Rises,64,91,-27,https://www.imdb.com/title/tt1345836/
69,3 Idiots,78,104,-26,https://www.imdb.com/title/tt1187043/
70,Like Stars on Earth,77,119,-42,https://www.imdb.com/title/tt0986264/
71,WALL·E,70,67,3,https://www.imdb.com/title/tt0910970/
72,The Lives of Others,67,34,33,https://www.imdb.com/title/tt0405094/
73,Oldboy,74,134,-60,https://www.imdb.com/title/tt0364569/
74,Memento,51,173,-122,https://www.imdb.com/title/tt0209144/
75,Princess Mononoke,75,99,-24,https://www.imdb.com/title/tt0119698/
76,Once Upon a Time in America,85,223,-138,https://www.imdb.com/title/tt0087843/
77,Indiana Jones and the Raiders of the Lost Ark,56,198,-142,https://www.imdb.com/title/tt0082971/
78,The Shining,65,129,-64,https://www.imdb.com/title/tt0081505/
79,Apocalypse Now,54,225,-171,https://www.imdb.com/title/tt0078788/
80,Alien,45,164,-119,https://www.imdb.com/title/tt0078748/
82,Dr. Strangelove or: How I Learned to Stop Worrying and Love the Bomb,66,272,-206,https://www.imdb.com/title/tt0057012/
83,Witness for the Prosecution,63,52,11,https://www.imdb.com/title/tt0051201/
84,Paths of Glory,61,245,-184,https://www.imdb.com/title/tt0050825/
85,Rear Window,57,48,9,https://www.imdb.com/title/tt0047396/
86,Sunset Blvd.,76,61,15,https://www.imdb.com/title/tt0043014/
87,The Great Dictator,60,42,18,https://www.imdb.com/title/tt0032553/
88,1917,128,122,6,https://www.imdb.com/title/tt8579674/
90,The Hunt,124,152,-28,https://www.imdb.com/title/tt2106476/
91,A Separation,94,197,-103,https://www.imdb.com/title/tt1832382/
92,Incendies,137,73,64,https://www.imdb.com/title/tt1255953/
96,Inglourious Basterds,107,101,6,https://www.imdb.com/title/tt0361748/
97,Eternal Sunshine of the Spotless Mind,122,106,16,https://www.imdb.com/title/tt0338013/
98,Amélie,131,53,78,https://www.imdb.com/title/tt0211915/
99,Snatch,90,318,-228,https://www.imdb.com/title/tt0208092/
100,Requiem for a Dream,118,108,10,https://www.imdb.com/title/tt0180093/
101,American Beauty,71,268,-197,https://www.imdb.com/title/tt0169547/
102,Good Will Hunting,100,174,-74,https://www.imdb.com/title/tt0119217/
104,Toy Story,80,169,-89,https://www.imdb.com/title/tt0114709/
105,Braveheart,87,400,-313,https://www.imdb.com/title/tt0112573/
106,Reservoir Dogs,97,257,-160,https://www.imdb.com/title/tt0105236/
107,Full Metal Jacket,114,295,-181,https://www.imdb.com/title/tt0093058/
109,Aliens,72,258,-186,https://www.imdb.com/title/tt0090605/
110,Amadeus,84,103,-19,https://www.imdb.com/title/tt0086879/
111,Scarface,105,411,-306,https://www.imdb.com/title/tt0086250/
112,Star Wars: Episode VI - Return of the Jedi,83,110,-27,https://www.imdb.com/title/tt0086190/
113,Das Boot,86,354,-268,https://www.imdb.com/title/tt0082096/
114,The Sting,103,208,-105,https://www.imdb.com/title/tt0070735/
115,A Clockwork Orange,109,260,-151,https://www.imdb.com/title/tt0066921/
117,2001: A Space Odyssey,82,479,-397,https://www.imdb.com/title/tt0062622/
118,Lawrence of Arabia,108,437,-329,https://www.imdb.com/title/tt0056172/
119,The Apartment,98,251,-153,https://www.imdb.com/title/tt0053604/
120,North by Northwest,115,184,-69,https://www.imdb.com/title/tt0053125/
121,Vertigo,92,162,-70,https://www.imdb.com/title/tt0052357/
122,Singin' in the Rain,145,45,100,https://www.imdb.com/title/tt0045152/
124,Bicycle Thieves,102,153,-51,https://www.imdb.com/title/tt0040522/
125,Double Indemnity,89,292,-203,https://www.imdb.com/title/tt0036775/
126,Citizen Kane,111,335,-224,https://www.imdb.com/title/tt0033467/
127,M,91,123,-32,https://www.imdb.com/title/tt0022100/
128,Metropolis,132,124,8,https://www.imdb.com/title/tt0017136/
129,The Kid,116,77,39,https://www.imdb.com/title/tt0012349/
134,Green Book,175,89,86,https://www.imdb.com/title/tt6966692/
137,Klaus,298,62,236,https://www.imdb.com/title/tt4729430/
146,The Secret in Their Eyes,152,176,-24,https://www.imdb.com/title/tt1305806/
147,Warrior,181,206,-25,https://www.imdb.com/title/tt1291584/
148,Shutter Island,176,196,-20,https://www.imdb.com/title/tt1130884/
149,Up,151,69,82,https://www.imdb.com/title/tt1049413/
151,The Wolf of Wall Street,125,656,-531,https://www.imdb.com/title/tt0993846/
153,There Will Be Blood,216,626,-410,https://www.imdb.com/title/tt0469494/
154,Pan's Labyrinth,167,133,34,https://www.imdb.com/title/tt0457430/
155,Toy Story 3,96,148,-52,https://www.imdb.com/title/tt0435761/
156,V for Vendetta,169,218,-49,https://www.imdb.com/title/tt0434409/
157,Rang De Basanti,182,1063,-881,https://www.imdb.com/title/tt0405508/
159,Batman Begins,120,372,-252,https://www.imdb.com/title/tt0372784/
161,Downfall,138,326,-188,https://www.imdb.com/title/tt0363163/
162,Howl's Moving Castle,318,27,291,https://www.imdb.com/title/tt0347149/
163,A Beautiful Mind,154,150,4,https://www.imdb.com/title/tt0268978/
165,"Lock, Stock and Two Smoking Barrels",179,323,-144,https://www.imdb.com/title/tt0120735/
166,L.A. Confidential,119,460,-341,https://www.imdb.com/title/tt0119488/
168,Heat,126,648,-522,https://www.imdb.com/title/tt0113277/
169,Casino,160,569,-409,https://www.imdb.com/title/tt0112641/
171,Unforgiven,139,736,-597,https://www.imdb.com/title/tt0105695/
172,Indiana Jones and the Last Crusade,135,300,-165,https://www.imdb.com/title/tt0097576/
174,My Neighbor Totoro,239,66,173,https://www.imdb.com/title/tt0096283/
175,Die Hard,117,572,-455,https://www.imdb.com/title/tt0095016/
176,Ran,140,347,-207,https://www.imdb.com/title/tt0089881/
177,Raging Bull,147,833,-686,https://www.imdb.com/title/tt0081398/
178,Stalker,225,151,74,https://www.imdb.com/title/tt0079944/
180,Taxi Driver,101,378,-277,https://www.imdb.com/title/tt0075314/
183,Monty Python and the Holy Grail,144,199,-55,https://www.imdb.com/title/tt0071853/
184,For a Few Dollars More,121,467,-346,https://www.imdb.com/title/tt0059578/
185,The Great Escape,142,312,-170,https://www.imdb.com/title/tt0057115/
186,To Kill a Mockingbird,123,70,53,https://www.imdb.com/title/tt0056592/
187,Yojimbo,113,507,-394,https://www.imdb.com/title/tt0055630/
189,Some Like It Hot,173,93,80,https://www.imdb.com/title/tt0053291/
191,The Seventh Seal,219,221,-2,https://www.imdb.com/title/tt0050976/
192,Dial M for Murder,164,224,-60,https://www.imdb.com/title/tt0046912/
194,Rashomon,146,276,-130,https://www.imdb.com/title/tt0042876/
195,All About Eve,162,46,116,https://www.imdb.com/title/tt0042192/
196,The Treasure of the Sierra Madre,141,484,-343,https://www.imdb.com/title/tt0040897/
198,The Gold Rush,190,279,-89,https://www.imdb.com/title/tt0015864/
203,"Three Billboards Outside Ebbing, Missouri",253,190,63,https://www.imdb.com/title/tt5027774/
204,The Invisible Guest,407,171,236,https://www.imdb.com/title/tt4857264/
205,The Handmaiden,281,185,96,https://www.imdb.com/title/tt4016934/
209,Logan,345,510,-165,https://www.imdb.com/title/tt3315342/
210,Room,254,125,129,https://www.imdb.com/title/tt3170832/
211,Wild Tales,214,157,57,https://www.imdb.com/title/tt3011894/
212,Soul,400,192,208,https://www.imdb.com/title/tt2948372/
215,PK,246,336,-90,https://www.imdb.com/title/tt2338151/
217,The Grand Budapest Hotel,274,212,62,https://www.imdb.com/title/tt2278388/
218,Gone Girl,184,285,-101,https://www.imdb.com/title/tt2267998/
221,Hacksaw Ridge,292,114,178,https://www.imdb.com/title/tt2119532/
222,Inside Out,186,160,26,https://www.imdb.com/title/tt2096673/
224,12 Years a Slave,271,242,29,https://www.imdb.com/title/tt2024544/
225,Rush,215,341,-126,https://www.imdb.com/title/tt1979320/
226,Ford v Ferrari,301,296,5,https://www.imdb.com/title/tt1950186/
227,Spotlight,283,262,21,https://www.imdb.com/title/tt1895587/
230,Prisoners,266,404,-138,https://www.imdb.com/title/tt1392214/
231,Mad Max: Fury Road,237,564,-327,https://www.imdb.com/title/tt1392190/
233,Zack Snyder's Justice League,279,387,-108,https://www.imdb.com/title/tt12361974/
234,Gran Torino,227,246,-19,https://www.imdb.com/title/tt1205489/
235,Harry Potter and the Deathly Hallows: Part 2,442,35,407,https://www.imdb.com/title/tt1201607/
237,Hachi: A Dog's Tale,316,83,233,https://www.imdb.com/title/tt1028532/
238,Mary and Max,310,74,236,https://www.imdb.com/title/tt0978762/
239,How to Train Your Dragon,355,63,292,https://www.imdb.com/title/tt0892769/
240,Into the Wild,262,264,-2,https://www.imdb.com/title/tt0758758/
241,No Country for Old Men,208,799,-591,https://www.imdb.com/title/tt0477348/
244,Million Dollar Baby,230,343,-113,https://www.imdb.com/title/tt0405159/
245,Hotel Rwanda,297,175,122,https://www.imdb.com/title/tt0395169/
247,Before Sunset,352,463,-111,https://www.imdb.com/title/tt0381681/
249,Memories of Murder,197,465,-268,https://www.imdb.com/title/tt0353969/
251,Kill Bill: Vol. 1,250,293,-43,https://www.imdb.com/title/tt0266697/
252,Finding Nemo,287,107,180,https://www.imdb.com/title/tt0266543/
253,Catch Me If You Can,317,305,12,https://www.imdb.com/title/tt0264464/
254,Amores Perros,260,291,-31,https://www.imdb.com/title/tt0245712/
255,"Monsters, Inc.",402,149,253,https://www.imdb.com/title/tt0198781/
257,Lagaan: Once Upon a Time in India,280,827,-547,https://www.imdb.com/title/tt0169102/
258,The Sixth Sense,200,204,-4,https://www.imdb.com/title/tt0167404/
260,The Truman Show,221,356,-135,https://www.imdb.com/title/tt0120382/
262,The Big Lebowski,174,733,-559,https://www.imdb.com/title/tt0118715/
263,In the Mood for Love,330,188,142,https://www.imdb.com/title/tt0118694/
264,Trainspotting,231,267,-36,https://www.imdb.com/title/tt0117951/
265,Fargo,195,408,-213,https://www.imdb.com/title/tt0116282/
267,La Haine,278,350,-72,https://www.imdb.com/title/tt0113247/
269,Before Sunrise,249,309,-60,https://www.imdb.com/title/tt0112471/
272,Jurassic Park,205,431,-226,https://www.imdb.com/title/tt0107290/
273,In the Name of the Father,252,210,42,https://www.imdb.com/title/tt0107207/
276,Dead Poets Society,408,130,278,https://www.imdb.com/title/tt0097165/
277,Stand by Me,366,145,221,https://www.imdb.com/title/tt0092005/
278,Platoon,259,619,-360,https://www.imdb.com/title/tt0091763/
281,Nausicaä of the Valley of the Wind,270,287,-17,https://www.imdb.com/title/tt0087544/
282,The Thing,199,785,-586,https://www.imdb.com/title/tt0084787/
286,Blade Runner,155,643,-488,https://www.imdb.com/title/tt0083658/
287,The Elephant Man,202,159,43,https://www.imdb.com/title/tt0080678/
288,Monty Python's Life of Brian,234,409,-175,https://www.imdb.com/title/tt0079470/
289,The Deer Hunter,198,294,-96,https://www.imdb.com/title/tt0077416/
290,Rocky,261,1073,-812,https://www.imdb.com/title/tt0075148/
291,Network,251,480,-229,https://www.imdb.com/title/tt0074958/
292,Barry Lyndon,228,888,-660,https://www.imdb.com/title/tt0072684/
294,Chinatown,196,527,-331,https://www.imdb.com/title/tt0071315/
299,Cool Hand Luke,206,421,-215,https://www.imdb.com/title/tt0061512/
300,Persona,302,186,116,https://www.imdb.com/title/tt0060827/
310,The 400 Blows,305,273,32,https://www.imdb.com/title/tt0053198/
311,Ben-Hur,210,578,-368,https://www.imdb.com/title/tt0052618/
315,The Bridge on the River Kwai,189,447,-258,https://www.imdb.com/title/tt0050212/
317,On the Waterfront,193,320,-127,https://www.imdb.com/title/tt0047296/
321,The Third Man,177,314,-137,https://www.imdb.com/title/tt0041959/
324,Rebecca,327,131,196,https://www.imdb.com/title/tt0032976/
325,Mr. Smith Goes to Washington,209,222,-13,https://www.imdb.com/title/tt0031679/
326,Gone with the Wind,324,39,285,https://www.imdb.com/title/tt0031381/
339,La La Land,339,694,-355,https://www.imdb.com/title/tt3783958/
340,Lion,463,116,347,https://www.imdb.com/title/tt3741834/
341,The Martian,421,407,14,https://www.imdb.com/title/tt3659388/
342,Zootopia,433,191,242,https://www.imdb.com/title/tt2948356/
343,Baahubali: The Beginning,429,853,-424,https://www.imdb.com/title/tt2631186/
345,Wonder,560,229,331,https://www.imdb.com/title/tt2543472/
349,The Raid 2,445,828,-383,https://www.imdb.com/title/tt2265171/
350,The Imitation Game,416,118,298,https://www.imdb.com/title/tt2084970/
351,Guardians of the Galaxy,338,328,10,https://www.imdb.com/title/tt2015381/
352,Blade Runner 2049,393,978,-585,https://www.imdb.com/title/tt1856101/
353,Her,311,800,-489,https://www.imdb.com/title/tt1798709/
354,Bohemian Rhapsody,607,75,532,https://www.imdb.com/title/tt1727824/
355,The Revenant,387,723,-336,https://www.imdb.com/title/tt1663202/
356,The Perks of Being a Wallflower,499,339,160,https://www.imdb.com/title/tt1659337/
358,The King's Speech,464,168,296,https://www.imdb.com/title/tt1504320/
359,The Help,487,82,405,https://www.imdb.com/title/tt1454029/
360,Deadpool,424,416,8,https://www.imdb.com/title/tt1431045/
363,Yip Man,361,545,-184,https://www.imdb.com/title/tt1220719/
366,Slumdog Millionaire,385,286,99,https://www.imdb.com/title/tt1010048/
367,Black Swan,419,410,9,https://www.imdb.com/title/tt0947798/
369,The Avengers,383,220,163,https://www.imdb.com/title/tt0848228/
371,Dallas Buyers Club,437,349,88,https://www.imdb.com/title/tt0790636/
372,The Pursuit of Happyness,451,450,1,https://www.imdb.com/title/tt0454921/
373,Blood Diamond,364,389,-25,https://www.imdb.com/title/tt0450259/
374,The Bourne Ultimatum,359,610,-251,https://www.imdb.com/title/tt0440963/
376,Sin City,328,956,-628,https://www.imdb.com/title/tt0401792/
377,The Diving Bell and the Butterfly,395,310,85,https://www.imdb.com/title/tt0401383/
379,Ratatouille,363,357,6,https://www.imdb.com/title/tt0382932/
380,Casino Royale,443,885,-442,https://www.imdb.com/title/tt0381061/
381,Kill Bill: Vol. 2,461,355,106,https://www.imdb.com/title/tt0378194/
385,Cinderella Man,371,573,-202,https://www.imdb.com/title/tt0352248/
386,Infernal Affairs,314,394,-80,https://www.imdb.com/title/tt0338564/
387,Pirates of the Caribbean: The Curse of the Black Pearl,423,214,209,https://www.imdb.com/title/tt0325980/
388,Big Fish,450,284,166,https://www.imdb.com/title/tt0319061/
389,The Incredibles,388,678,-290,https://www.imdb.com/title/tt0317705/
391,Dogville,444,234,210,https://www.imdb.com/title/tt0276919/
393,Donnie Darko,358,353,5,https://www.imdb.com/title/tt0246578/
394,Magnolia,372,855,-483,https://www.imdb.com/title/tt0175880/
395,Dancer in the Dark,489,346,143,https://www.imdb.com/title/tt0168629/
400,The Iron Giant,389,414,-25,https://www.imdb.com/title/tt0129167/
404,12 Monkeys,300,547,-247,https://www.imdb.com/title/tt0114746/
405,Ghost in the Shell,405,712,-307,https://www.imdb.com/title/tt0113568/
406,The Nightmare Before Christmas,522,140,382,https://www.imdb.com/title/tt0107688/
407,Groundhog Day,236,1029,-793,https://www.imdb.com/title/tt0107048/
409,Scent of a Woman,384,383,1,https://www.imdb.com/title/tt0105323/
410,Aladdin,418,177,241,https://www.imdb.com/title/tt0103639/
411,JFK,340,741,-401,https://www.imdb.com/title/tt0102138/
412,Beauty and the Beast,635,40,595,https://www.imdb.com/title/tt0101414/
413,Dances with Wolves,354,560,-206,https://www.imdb.com/title/tt0099348/
415,Rain Man,370,365,5,https://www.imdb.com/title/tt0095953/
416,Akira,378,709,-331,https://www.imdb.com/title/tt0094625/
417,The Princess Bride,398,170,228,https://www.imdb.com/title/tt0093779/
420,Castle in the Sky,374,412,-38,https://www.imdb.com/title/tt0092067/
421,The Terminator,248,826,-578,https://www.imdb.com/title/tt0088247/
422,Gandhi,334,440,-106,https://www.imdb.com/title/tt0083987/
425,Annie Hall,368,725,-357,https://www.imdb.com/title/tt0075686/
426,Jaws,272,949,-677,https://www.imdb.com/title/tt0073195/
427,Dog Day Afternoon,341,369,-28,https://www.imdb.com/title/tt0072890/
428,Young Frankenstein,365,261,104,https://www.imdb.com/title/tt0072431/
429,Papillon,325,477,-152,https://www.imdb.com/title/tt0070511/
430,The Exorcist,309,676,-367,https://www.imdb.com/title/tt0070047/
435,Butch Cassidy and the Sundance Kid,304,344,-40,https://www.imdb.com/title/tt0064115/
436,Rosemary's Baby,351,605,-254,https://www.imdb.com/title/tt0063522/
437,Planet of the Apes,427,870,-443,https://www.imdb.com/title/tt0063442/
438,The Graduate,343,636,-293,https://www.imdb.com/title/tt0061722/
440,The Sound of Music,579,86,493,https://www.imdb.com/title/tt0059742/
442,A Fistful of Dollars,392,881,-489,https://www.imdb.com/title/tt0058461/
443,8½,342,333,9,https://www.imdb.com/title/tt0056801/
457,Roman Holiday,457,211,246,https://www.imdb.com/title/tt0046250/
458,A Streetcar Named Desire,446,249,197,https://www.imdb.com/title/tt0044081/
461,Rope,401,403,-2,https://www.imdb.com/title/tt0040746/
467,The Maltese Falcon,346,587,-241,https://www.imdb.com/title/tt0033870/
469,The Wizard of Oz,394,180,214,https://www.imdb.com/title/tt0032138/
474,Knives Out,532,734,-202,https://www.imdb.com/title/tt8946378/
476,Marriage Story,481,762,-281,https://www.imdb.com/title/tt7653254/
477,Call Me by Your Name,794,167,627,https://www.imdb.com/title/tt5726616/
479,Isle of Dogs,654,376,278,https://www.imdb.com/title/tt5104604/
480,Hunt for the Wilderpeople,712,237,475,https://www.imdb.com/title/tt4698684/
481,Captain Fantastic,578,442,136,https://www.imdb.com/title/tt3553976/
483,Thor: Ragnarok,587,329,258,https://www.imdb.com/title/tt3501632/
484,Jojo Rabbit,591,230,361,https://www.imdb.com/title/tt2584384/
485,Arrival,516,474,42,https://www.imdb.com/title/tt2543164/
486,Star Wars: Episode VII - The Force Awakens,571,233,338,https://www.imdb.com/title/tt2488496/
487,Before Midnight,475,811,-336,https://www.imdb.com/title/tt2209418/
489,X-Men: Days of Future Past,447,316,131,https://www.imdb.com/title/tt1877832/
492,The Artist,573,290,283,https://www.imdb.com/title/tt1655442/
493,Edge of Tomorrow,480,792,-312,https://www.imdb.com/title/tt1631867/
496,Moon,538,576,-38,https://www.imdb.com/title/tt1182345/
497,Let the Right One In,521,746,-225,https://www.imdb.com/title/tt1139797/
498,District 9,406,906,-500,https://www.imdb.com/title/tt1136608/
499,The Wrestler,537,1049,-512,https://www.imdb.com/title/tt1125849/
501,Boyhood,448,923,-475,https://www.imdb.com/title/tt1065073/
503,Star Trek,474,236,238,https://www.imdb.com/title/tt0796366/
504,In Bruges,496,760,-264,https://www.imdb.com/title/tt0780536/
505,The Man from Earth,428,1002,-574,https://www.imdb.com/title/tt0756683/
506,Letters from Iwo Jima,505,757,-252,https://www.imdb.com/title/tt0498380/
507,The Fall,806,94,712,https://www.imdb.com/title/tt0460791/
508,Life of Pi,492,470,22,https://www.imdb.com/title/tt0454876/
509,Fantastic Mr. Fox,608,607,1,https://www.imdb.com/title/tt0432283/
513,Iron Man,574,599,-25,https://www.imdb.com/title/tt0371746/
514,Shaun of the Dead,517,541,-24,https://www.imdb.com/title/tt0365748/
517,Mystic River,493,513,-20,https://www.imdb.com/title/tt0327056/
518,Harry Potter and the Prisoner of Azkaban,723,165,558,https://www.imdb.com/title/tt0304141/
519,Hero,525,425,100,https://www.imdb.com/title/tt0299977/
520,Talk to Her,485,396,89,https://www.imdb.com/title/tt0287467/
523,The Bourne Identity,476,778,-302,https://www.imdb.com/title/tt0258463/
525,Children of Men,508,1004,-496,https://www.imdb.com/title/tt0206634/
526,Almost Famous,506,755,-249,https://www.imdb.com/title/tt0181875/
527,Mulholland Dr.,470,818,-348,https://www.imdb.com/title/tt0166924/
528,Toy Story 2,519,765,-246,https://www.imdb.com/title/tt0120363/
529,Boogie Nights,511,1280,-769,https://www.imdb.com/title/tt0118749/
532,True Romance,467,685,-218,https://www.imdb.com/title/tt0108399/
535,Carlito's Way,533,947,-414,https://www.imdb.com/title/tt0106519/
536,Edward Scissorhands,681,202,479,https://www.imdb.com/title/tt0099487/
539,The Untouchables,490,679,-189,https://www.imdb.com/title/tt0094226/
541,Brazil,527,558,-31,https://www.imdb.com/title/tt0088846/
542,This Is Spinal Tap,483,585,-102,https://www.imdb.com/title/tt0088258/
543,A Christmas Story,455,366,89,https://www.imdb.com/title/tt0085334/
544,The Blues Brothers,491,732,-241,https://www.imdb.com/title/tt0080455/
545,Manhattan,473,688,-215,https://www.imdb.com/title/tt0079522/
547,Dawn of the Dead,495,1226,-731,https://www.imdb.com/title/tt0077402/
548,All the President's Men,441,386,55,https://www.imdb.com/title/tt0074119/
556,Night of the Living Dead,523,859,-336,https://www.imdb.com/title/tt0063350/
561,Spartacus,462,866,-404,https://www.imdb.com/title/tt0054331/
568,Strangers on a Train,432,423,9,https://www.imdb.com/title/tt0044079/
581,The Gentlemen,705,674,31,https://www.imdb.com/title/tt8367814/
585,Dunkirk,588,561,27,https://www.imdb.com/title/tt5013056/
587,Hidden Figures,835,166,669,https://www.imdb.com/title/tt4846340/
590,Kubo and the Two Strings,729,469,260,https://www.imdb.com/title/tt4302938/
592,Manchester by the Sea,619,950,-331,https://www.imdb.com/title/tt4034228/
594,Rogue One: A Star Wars Story,702,808,-106,https://www.imdb.com/title/tt3748528/
595,Captain America: Civil War,677,695,-18,https://www.imdb.com/title/tt3498820/
596,The Hateful Eight,539,1247,-708,https://www.imdb.com/title/tt3460252/
597,Little Women,908,444,464,https://www.imdb.com/title/tt3281548/
600,Nightcrawler,531,999,-468,https://www.imdb.com/title/tt2872718/
605,Big Hero 6,830,240,590,https://www.imdb.com/title/tt2245084/
606,About Time,673,552,121,https://www.imdb.com/title/tt2194499/
609,Toy Story 4,770,775,-5,https://www.imdb.com/title/tt1979376/
610,The Best Offer,692,548,144,https://www.imdb.com/title/tt1924396/
611,Moonrise Kingdom,695,596,99,https://www.imdb.com/title/tt1748122/
612,How to Train Your Dragon 2,787,288,499,https://www.imdb.com/title/tt1646971/
613,The Big Short,593,1033,-440,https://www.imdb.com/title/tt1596363/
615,I Saw the Devil,586,977,-391,https://www.imdb.com/title/tt1588170/
616,The Girl with the Dragon Tattoo,589,382,207,https://www.imdb.com/title/tt1568346/
617,Captain Phillips,643,609,34,https://www.imdb.com/title/tt1535109/
619,Straight Outta Compton,650,566,84,https://www.imdb.com/title/tt1398426/
620,The Irishman,548,1503,-955,https://www.imdb.com/title/tt1302006/
623,The Hobbit: The Desolation of Smaug,687,358,329,https://www.imdb.com/title/tt1170358/
625,The Girl with the Dragon Tattoo,589,382,207,https://www.imdb.com/title/tt1132620/
626,Skyfall,715,896,-181,https://www.imdb.com/title/tt1074638/
627,The Trial of the Chicago 7,733,453,280,https://www.imdb.com/title/tt1070874/
629,The Fighter,598,802,-204,https://www.imdb.com/title/tt0964517/
630,Taken,652,837,-185,https://www.imdb.com/title/tt0936501/
631,The Boy in the Striped Pajamas,885,226,659,https://www.imdb.com/title/tt0914798/
632,Once,546,900,-354,https://www.imdb.com/title/tt0907657/
633,The Hobbit: An Unexpected Journey,606,306,300,https://www.imdb.com/title/tt0903624/
635,Atonement,784,504,280,https://www.imdb.com/title/tt0783233/
636,Drive,597,1238,-641,https://www.imdb.com/title/tt0780504/
637,American Gangster,605,1024,-419,https://www.imdb.com/title/tt0765429/
638,Avatar,552,899,-347,https://www.imdb.com/title/tt0499549/
639,Mr. Nobody,631,515,116,https://www.imdb.com/title/tt0485947/
640,Apocalypto,616,615,1,https://www.imdb.com/title/tt0472043/
641,Little Miss Sunshine,656,438,218,https://www.imdb.com/title/tt0449059/
642,Hot Fuzz,604,628,-24,https://www.imdb.com/title/tt0425112/
643,The Curious Case of Benjamin Button,599,704,-105,https://www.imdb.com/title/tt0421715/
646,Pride & Prejudice,1223,213,1010,https://www.imdb.com/title/tt0414387/
648,Serenity,617,235,382,https://www.imdb.com/title/tt0379786/
649,Walk the Line,620,398,222,https://www.imdb.com/title/tt0358273/
651,The Notebook,841,216,625,https://www.imdb.com/title/tt0332280/
656,The Count of Monte Cristo,793,611,182,https://www.imdb.com/title/tt0245844/
658,Remember the Titans,764,456,308,https://www.imdb.com/title/tt0210945/
659,"Crouching Tiger, Hidden Dragon",584,600,-16,https://www.imdb.com/title/tt0190332/
661,Cast Away,610,915,-305,https://www.imdb.com/title/tt0162222/
662,The Boondock Saints,716,319,397,https://www.imdb.com/title/tt0144117/
663,The Insider,630,946,-316,https://www.imdb.com/title/tt0140352/
665,Shrek,564,445,119,https://www.imdb.com/title/tt0126029/
666,Titanic,820,289,531,https://www.imdb.com/title/tt0120338/
668,Gattaca,672,742,-70,https://www.imdb.com/title/tt0119177/
669,The Game,661,935,-274,https://www.imdb.com/title/tt0119174/
671,Ed Wood,609,1015,-406,https://www.imdb.com/title/tt0109707/
672,What's Eating Gilbert Grape,872,462,410,https://www.imdb.com/title/tt0108550/
673,Tombstone,628,435,193,https://www.imdb.com/title/tt0108358/
677,The Fugitive,615,897,-282,https://www.imdb.com/title/tt0106977/
678,A Bronx Tale,732,667,65,https://www.imdb.com/title/tt0106489/
683,Boyz n the Hood,768,835,-67,https://www.imdb.com/title/tt0101507/
684,Misery,621,528,93,https://www.imdb.com/title/tt0100157/
685,Awakenings,641,406,235,https://www.imdb.com/title/tt0099077/
686,Kiki's Delivery Service,662,455,207,https://www.imdb.com/title/tt0097814/
687,Glory,596,542,54,https://www.imdb.com/title/tt0097441/
689,Back to the Future Part II,566,787,-221,https://www.imdb.com/title/tt0096874/
691,Predator,551,1657,-1106,https://www.imdb.com/title/tt0093773/
692,Evil Dead II,646,1463,-817,https://www.imdb.com/title/tt0092991/
693,Ferris Bueller's Day Off,667,658,9,https://www.imdb.com/title/tt0091042/
695,The Goonies,769,392,377,https://www.imdb.com/title/tt0089218/
697,The Breakfast Club,657,391,266,https://www.imdb.com/title/tt0088847/
699,Ghostbusters,691,1076,-385,https://www.imdb.com/title/tt0087332/
702,E.T. the Extra-Terrestrial,559,520,39,https://www.imdb.com/title/tt0083866/
703,Kramer vs. Kramer,674,692,-18,https://www.imdb.com/title/tt0079417/
707,The Conversation,570,879,-309,https://www.imdb.com/title/tt0071360/
712,Willy Wonka & the Chocolate Factory,648,549,99,https://www.imdb.com/title/tt0067992/
713,Midnight Cowboy,557,805,-248,https://www.imdb.com/title/tt0064665/
716,Bonnie and Clyde,701,831,-130,https://www.imdb.com/title/tt0061418/
718,Mary Poppins,857,298,559,https://www.imdb.com/title/tt0058331/
736,Roma,822,952,-130,https://www.imdb.com/title/tt6155172/
738,Deadpool 2,852,797,55,https://www.imdb.com/title/tt5463162/
739,Wind River,816,945,-129,https://www.imdb.com/title/tt5362988/
740,Get Out,825,832,-7,https://www.imdb.com/title/tt5052448/
741,Mission: Impossible - Fallout,756,1285,-529,https://www.imdb.com/title/tt4912910/
744,What We Do in the Shadows,890,476,414,https://www.imdb.com/title/tt3416742/
746,The Theory of Everything,936,478,458,https://www.imdb.com/title/tt2980516/
747,Kingsman: The Secret Service,805,666,139,https://www.imdb.com/title/tt2802144/
748,The Fault in Our Stars,884,669,215,https://www.imdb.com/title/tt2582846/
749,Me and Earl and the Dying Girl,727,788,-61,https://www.imdb.com/title/tt2582496/
750,Birdman or (The Unexpected Virtue of Ignorance),645,1336,-691,https://www.imdb.com/title/tt2562232/
751,Blue Is the Warmest Colour,734,904,-170,https://www.imdb.com/title/tt2278871/
754,Captain America: The Winter Soldier,780,618,162,https://www.imdb.com/title/tt1843866/
756,Nebraska,703,790,-87,https://www.imdb.com/title/tt1821549/
757,Wreck-It Ralph,788,823,-35,https://www.imdb.com/title/tt1772341/
760,Midnight in Paris,845,1106,-261,https://www.imdb.com/title/tt1605783/
761,The Lego Movie,666,995,-329,https://www.imdb.com/title/tt1490017/
762,Gravity,676,1366,-690,https://www.imdb.com/title/tt1454468/
763,Star Trek Into Darkness,866,429,437,https://www.imdb.com/title/tt1408101/
765,The Social Network,663,1497,-834,https://www.imdb.com/title/tt1285016/
766,X-Men: First Class,754,579,175,https://www.imdb.com/title/tt1270798/
767,The Hangover,678,1242,-564,https://www.imdb.com/title/tt1119646/
768,Silver Linings Playbook,699,980,-281,https://www.imdb.com/title/tt1045658/
769,Argo,859,653,206,https://www.imdb.com/title/tt1024648/
770,500 Days of Summer,747,1222,-475,https://www.imdb.com/title/tt1022603/
771,Harry Potter and the Deathly Hallows: Part 1,1146,187,959,https://www.imdb.com/title/tt0926084/
772,Ponyo,937,690,247,https://www.imdb.com/title/tt0876563/
773,Frost/Nixon,821,873,-52,https://www.imdb.com/title/tt0870111/
775,Changeling,752,756,-4,https://www.imdb.com/title/tt0824747/
779,This Is England,896,834,62,https://www.imdb.com/title/tt0480025/
780,Ex Machina,711,1132,-421,https://www.imdb.com/title/tt0470752/
782,The Last King of Scotland,808,686,122,https://www.imdb.com/title/tt0455590/
783,Zodiac,832,1343,-511,https://www.imdb.com/title/tt0443706/
784,Lucky Number Slevin,792,683,109,https://www.imdb.com/title/tt0425210/
787,Tangled,960,297,663,https://www.imdb.com/title/tt0398286/
789,Brokeback Mountain,1071,553,518,https://www.imdb.com/title/tt0388795/
790,3:10 to Yuma,803,842,-39,https://www.imdb.com/title/tt0381849/
791,Crash,679,721,-42,https://www.imdb.com/title/tt0375679/
792,Kung Fu Hustle,725,745,-20,https://www.imdb.com/title/tt0373074/
793,The Bourne Supremacy,744,953,-209,https://www.imdb.com/title/tt0372183/
794,The Machinist,814,841,-27,https://www.imdb.com/title/tt0361862/
795,Ray,785,801,-16,https://www.imdb.com/title/tt0350258/
796,Lost in Translation,664,1462,-798,https://www.imdb.com/title/tt0335266/
797,Harry Potter and the Goblet of Fire,1130,361,769,https://www.imdb.com/title/tt0330373/
798,Man on Fire,828,804,24,https://www.imdb.com/title/tt0328107/
799,Coraline,883,747,136,https://www.imdb.com/title/tt0327597/
800,The Last Samurai,728,1289,-561,https://www.imdb.com/title/tt0325710/
802,Good Bye Lenin!,807,551,256,https://www.imdb.com/title/tt0301357/
804,I Am Sam,1116,488,628,https://www.imdb.com/title/tt0277027/
805,Adaptation.,817,1626,-809,https://www.imdb.com/title/tt0268126/
806,Black Hawk Down,748,1330,-582,https://www.imdb.com/title/tt0265086/
807,Road to Perdition,815,1205,-390,https://www.imdb.com/title/tt0257044/
809,Billy Elliot,1028,375,653,https://www.imdb.com/title/tt0249462/
811,Ocean's Eleven,649,852,-203,https://www.imdb.com/title/tt0240772/
813,"O Brother, Where Art Thou?",774,829,-55,https://www.imdb.com/title/tt0190590/
815,"South Park: Bigger, Longer & Uncut",680,1516,-836,https://www.imdb.com/title/tt0158983/
816,Office Space,721,1263,-542,https://www.imdb.com/title/tt0151804/
818,Training Day,651,1436,-785,https://www.imdb.com/title/tt0139654/
819,Rushmore,836,1282,-446,https://www.imdb.com/title/tt0128445/
821,Being John Malkovich,790,1097,-307,https://www.imdb.com/title/tt0120601/
822,As Good as It Gets,777,974,-197,https://www.imdb.com/title/tt0119822/
823,The Fifth Element,843,575,268,https://www.imdb.com/title/tt0119116/
825,Donnie Brasco,660,1016,-356,https://www.imdb.com/title/tt0119008/
827,Primal Fear,899,597,302,https://www.imdb.com/title/tt0117381/
832,Clerks,669,1283,-614,https://www.imdb.com/title/tt0109445/
834,Philadelphia,844,401,443,https://www.imdb.com/title/tt0107818/
838,The Last of the Mohicans,791,776,15,https://www.imdb.com/title/tt0104691/
841,A Few Good Men,888,957,-69,https://www.imdb.com/title/tt0104257/
843,Barton Fink,802,1288,-486,https://www.imdb.com/title/tt0101410/
844,Miller's Crossing,634,1191,-557,https://www.imdb.com/title/tt0100150/
845,Who Framed Roger Rabbit,846,1043,-197,https://www.imdb.com/title/tt0096438/
849,Empire of the Sun,798,402,396,https://www.imdb.com/title/tt0092965/
850,The Name of the Rose,700,1010,-310,https://www.imdb.com/title/tt0091605/
851,Blue Velvet,720,1414,-694,https://www.imdb.com/title/tt0090756/
856,Star Trek II: The Wrath of Khan,799,1052,-253,https://www.imdb.com/title/tt0084726/
857,First Blood,775,1842,-1067,https://www.imdb.com/title/tt0083944/
859,Airplane!,659,1377,-718,https://www.imdb.com/title/tt0080339/
861,Halloween,710,1216,-506,https://www.imdb.com/title/tt0077651/
865,Blazing Saddles,760,782,-22,https://www.imdb.com/title/tt0071230/
866,Serpico,750,819,-69,https://www.imdb.com/title/tt0070666/
869,The French Connection,749,1482,-733,https://www.imdb.com/title/tt0067116/
870,Dirty Harry,658,1270,-612,https://www.imdb.com/title/tt0066999/
878,Goldfinger,707,1643,-936,https://www.imdb.com/title/tt0058150/
879,The Birds,842,845,-3,https://www.imdb.com/title/tt0056869/
898,The Two Popes,1097,919,178,https://www.imdb.com/title/tt8404614/
900,Searching,1003,930,73,https://www.imdb.com/title/tt7668870/
903,Once Upon a Time... In Hollywood,919,1475,-556,https://www.imdb.com/title/tt7131622/
908,Train to Busan,1158,691,467,https://www.imdb.com/title/tt5700672/
911,"Love, Simon",1289,860,429,https://www.imdb.com/title/tt5164432/
913,Gifted,1018,815,203,https://www.imdb.com/title/tt4481414/
917,Guardians of the Galaxy Vol. 2,1068,660,408,https://www.imdb.com/title/tt3896198/
918,Baby Driver,1080,1227,-147,https://www.imdb.com/title/tt3890160/
921,Bridge of Spies,995,1138,-143,https://www.imdb.com/title/tt3682448/
922,Incredibles 2,981,743,238,https://www.imdb.com/title/tt3606756/
923,Moana,1163,517,646,https://www.imdb.com/title/tt3521164/
924,Sicario,855,1711,-856,https://www.imdb.com/title/tt3397884/
925,Creed,1008,1265,-257,https://www.imdb.com/title/tt3076658/
928,Fury,972,1268,-296,https://www.imdb.com/title/tt2713180/
929,Hell or High Water,858,1486,-628,https://www.imdb.com/title/tt2582782/
933,Dawn of the Planet of the Apes,989,1318,-329,https://www.imdb.com/title/tt2103281/
936,The Raid: Redemption,913,1438,-525,https://www.imdb.com/title/tt1899353/
937,End of Watch,904,1123,-219,https://www.imdb.com/title/tt1855199/
939,Les Misérables,1236,635,601,https://www.imdb.com/title/tt1707386/
940,The Impossible,1234,532,702,https://www.imdb.com/title/tt1649419/
942,A Star Is Born,950,867,83,https://www.imdb.com/title/tt1517451/
943,The Greatest Showman,1329,568,761,https://www.imdb.com/title/tt1485796/
947,True Grit,903,1244,-341,https://www.imdb.com/title/tt1403865/
950,Despicable Me,1074,516,558,https://www.imdb.com/title/tt1323594/
951,Rise of the Planet of the Apes,1110,1200,-90,https://www.imdb.com/title/tt1318514/
952,A Single Man,1267,663,604,https://www.imdb.com/title/tt1315981/
953,50/50,878,998,-120,https://www.imdb.com/title/tt1306980/
954,Kick-Ass,840,1465,-625,https://www.imdb.com/title/tt1250777/
956,Moneyball,881,1717,-836,https://www.imdb.com/title/tt1210166/
958,The Skin I Live In,951,803,148,https://www.imdb.com/title/tt1189073/
959,Zombieland,978,1054,-76,https://www.imdb.com/title/tt1156398/
962,The Wave,973,715,258,https://www.imdb.com/title/tt1063669/
964,Sherlock Holmes,1016,892,124,https://www.imdb.com/title/tt0988045/
967,The Reader,1095,689,406,https://www.imdb.com/title/tt0976051/
968,The Blind Side,1078,458,620,https://www.imdb.com/title/tt0878804/
970,Superbad,964,1856,-892,https://www.imdb.com/title/tt0829482/
971,The Book Thief,1309,529,780,https://www.imdb.com/title/tt0816442/
972,Seven Pounds,959,793,166,https://www.imdb.com/title/tt0814314/
974,Eastern Promises,946,992,-46,https://www.imdb.com/title/tt0765443/
975,Stardust,1026,737,289,https://www.imdb.com/title/tt0486655/
979,Inside Man,930,1236,-306,https://www.imdb.com/title/tt0454848/
980,Gone Baby Gone,932,1241,-309,https://www.imdb.com/title/tt0452623/
985,The Illusionist,923,958,-35,https://www.imdb.com/title/tt0443543/
987,Kung Fu Panda,970,1466,-496,https://www.imdb.com/title/tt0441773/
988,Thank You for Smoking,986,1495,-509,https://www.imdb.com/title/tt0427944/
992,Harry Potter and the Half-Blood Prince,1336,417,919,https://www.imdb.com/title/tt0417741/
993,300,853,1365,-512,https://www.imdb.com/title/tt0416449/
994,Match Point,839,1293,-454,https://www.imdb.com/title/tt0416320/
995,Watchmen,789,1843,-1054,https://www.imdb.com/title/tt0409459/
996,Lord of War,998,1476,-478,https://www.imdb.com/title/tt0399295/
997,Saw,882,1306,-424,https://www.imdb.com/title/tt0387564/
1004,21 Grams,831,771,60,https://www.imdb.com/title/tt0315733/
1005,Love Actually,1186,627,559,https://www.imdb.com/title/tt0314331/
1007,Finding Neverland,947,632,315,https://www.imdb.com/title/tt0308644/
1008,25th Hour,850,1094,-244,https://www.imdb.com/title/tt0307901/
1009,The Life of David Gale,1162,538,624,https://www.imdb.com/title/tt0289992/
1010,The Butterfly Effect,818,987,-169,https://www.imdb.com/title/tt0289879/
1011,28 Days Later...,1031,1150,-119,https://www.imdb.com/title/tt0289043/
1012,Battle Royale,984,911,73,https://www.imdb.com/title/tt0266308/
1013,The Royal Tenenbaums,1041,907,134,https://www.imdb.com/title/tt0265666/
1014,Y Tu Mamá También,875,1269,-394,https://www.imdb.com/title/tt0245574/
1015,Harry Potter and the Sorcerer's Stone,1363,253,1110,https://www.imdb.com/title/tt0241527/
1017,The Others,1062,850,212,https://www.imdb.com/title/tt0230600/
1018,Blow,1012,1223,-211,https://www.imdb.com/title/tt0221027/
1019,Enemy at the Gates,934,1232,-298,https://www.imdb.com/title/tt0215750/
1020,Moulin Rouge!,1364,533,831,https://www.imdb.com/title/tt0203009/
1021,Traffic,979,1533,-554,https://www.imdb.com/title/tt0181865/
1022,Minority Report,935,1239,-304,https://www.imdb.com/title/tt0181689/
1026,American Psycho,968,1249,-281,https://www.imdb.com/title/tt0144084/
1027,Run Lola Run,920,729,191,https://www.imdb.com/title/tt0130827/
1028,The Thin Red Line,849,1207,-358,https://www.imdb.com/title/tt0120863/
1030,Mulan,1360,278,1082,https://www.imdb.com/title/tt0120762/
1031,Fear and Loathing in Las Vegas,910,1426,-516,https://www.imdb.com/title/tt0120669/
1033,Dark City,848,1140,-292,https://www.imdb.com/title/tt0118929/
1034,Star Trek: First Contact,1067,1000,67,https://www.imdb.com/title/tt0117731/
1035,Sleepers,1010,731,279,https://www.imdb.com/title/tt0117665/
1036,Lost Highway,983,1319,-336,https://www.imdb.com/title/tt0116922/
1037,Sense and Sensibility,1347,554,793,https://www.imdb.com/title/tt0114388/
1038,Die Hard with a Vengeance,905,1308,-403,https://www.imdb.com/title/tt0112864/
1041,Apollo 13,876,1030,-154,https://www.imdb.com/title/tt0112384/
1044,Legends of the Fall,1211,836,375,https://www.imdb.com/title/tt0110322/
1045,The Crow,1188,681,507,https://www.imdb.com/title/tt0109506/
1049,Falling Down,975,1514,-539,https://www.imdb.com/title/tt0106856/
1050,Dazed and Confused,961,1515,-554,https://www.imdb.com/title/tt0106677/
1051,My Cousin Vinny,1079,1051,28,https://www.imdb.com/title/tt0104952/
1056,The Hunt for Red October,1032,1370,-338,https://www.imdb.com/title/tt0099810/
1057,Home Alone,1057,886,171,https://www.imdb.com/title/tt0099785/
1058,The Godfather: Part III,957,1032,-75,https://www.imdb.com/title/tt0099674/
1059,When Harry Met Sally...,1013,921,92,https://www.imdb.com/title/tt0098635/
1060,National Lampoon's Christmas Vacation,1167,1120,47,https://www.imdb.com/title/tt0097958/
1062,The Little Mermaid,1549,265,1284,https://www.imdb.com/title/tt0097757/
1064,The Naked Gun: From the Files of Police Squad!,909,1918,-1009,https://www.imdb.com/title/tt0095705/
1068,RoboCop,999,1934,-935,https://www.imdb.com/title/tt0093870/
1069,"Planes, Trains & Automobiles",993,1554,-561,https://www.imdb.com/title/tt0093748/
1070,Lethal Weapon,901,1367,-466,https://www.imdb.com/title/tt0093409/
1071,The Fly,949,1738,-789,https://www.imdb.com/title/tt0091064/
1073,Indiana Jones and the Temple of Doom,1050,1145,-95,https://www.imdb.com/title/tt0087469/
1078,The Road Warrior,873,1805,-932,https://www.imdb.com/title/tt0082694/
1082,Escape from Alcatraz,974,1220,-246,https://www.imdb.com/title/tt0079116/
1086,Close Encounters of the Third Kind,894,1278,-384,https://www.imdb.com/title/tt0075860/
1088,Robin Hood,1086,843,243,https://www.imdb.com/title/tt0070608/
1097,The Jungle Book,924,1069,-145,https://www.imdb.com/title/tt0061852/
1104,Breakfast at Tiffany's,1133,475,658,https://www.imdb.com/title/tt0054698/
1115,Snow White and the Seven Dwarfs,991,893,98,https://www.imdb.com/title/tt0029583/
1121,The Lighthouse,1272,1930,-658,https://www.imdb.com/title/tt7984734/
1122,BlacKkKlansman,1341,908,433,https://www.imdb.com/title/tt7349662/
1125,Tenet,1357,1737,-380,https://www.imdb.com/title/tt6723592/
1126,A Quiet Place,1237,1078,159,https://www.imdb.com/title/tt6644200/
1127,Upgrade,1089,1552,-463,https://www.imdb.com/title/tt6499752/
1128,Spider-Man: Far from Home,1318,903,415,https://www.imdb.com/title/tt6320628/
1129,Phantom Thread,1147,1795,-648,https://www.imdb.com/title/tt5776858/
1131,"I, Tonya",1276,1212,64,https://www.imdb.com/title/tt5580036/
1132,The Big Sick,1049,1355,-306,https://www.imdb.com/title/tt5462602/
1135,The Favourite,1030,1419,-389,https://www.imdb.com/title/tt5083738/
1136,Nocturnal Animals,1159,1479,-320,https://www.imdb.com/title/tt4550098/
1138,John Wick: Chapter 2,1323,1608,-285,https://www.imdb.com/title/tt4425200/
1143,Still Alice,1274,963,311,https://www.imdb.com/title/tt3316960/
1147,Predestination,1168,1387,-219,https://www.imdb.com/title/tt2397535/
1148,How to Train Your Dragon: The Hidden World,1469,673,796,https://www.imdb.com/title/tt2386490/
1149,Brooklyn,1296,1060,236,https://www.imdb.com/title/tt2381111/
1153,Saving Mr. Banks,1382,927,455,https://www.imdb.com/title/tt2140373/
1155,Inside Llewyn Davis,1164,1837,-673,https://www.imdb.com/title/tt2042568/
1156,The Hunger Games: Catching Fire,1367,360,1007,https://www.imdb.com/title/tt1951264/
1158,127 Hours,944,1208,-264,https://www.imdb.com/title/tt1542344/
1159,Sherlock Holmes: A Game of Shadows,1213,1064,149,https://www.imdb.com/title/tt1515091/
1161,Tucker and Dale vs Evil,1087,1087,0,https://www.imdb.com/title/tt1465522/
1162,The Conjuring,1227,1273,-46,https://www.imdb.com/title/tt1457767/
1168,We Need to Talk About Kevin,1262,847,415,https://www.imdb.com/title/tt1242460/
1170,Doctor Strange,1209,961,248,https://www.imdb.com/title/tt1211837/
1172,Lone Survivor,1189,898,291,https://www.imdb.com/title/tt1091191/
1175,Milk,1150,830,320,https://www.imdb.com/title/tt1013753/
1176,Hugo,1202,1104,98,https://www.imdb.com/title/tt0970179/
1177,Source Code,1192,1452,-260,https://www.imdb.com/title/tt0945513/
1178,Doubt,1105,1371,-266,https://www.imdb.com/title/tt0918927/
1179,The Hurt Locker,1045,1361,-316,https://www.imdb.com/title/tt0887912/
1180,The Town,1072,1585,-513,https://www.imdb.com/title/tt0840361/
1185,Grindhouse,1053,1020,33,https://www.imdb.com/title/tt0462322/
1189,Scott Pilgrim vs. the World,1081,1617,-536,https://www.imdb.com/title/tt0446029/
1190,The Assassination of Jesse James by the Coward Robert Ford,1178,1670,-492,https://www.imdb.com/title/tt0443680/
1192,August Rush,1411,750,661,https://www.imdb.com/title/tt0426931/
1193,Stranger Than Fiction,1022,1142,-120,https://www.imdb.com/title/tt0420223/
1196,Munich,1006,1576,-570,https://www.imdb.com/title/tt0408306/
1197,Little Children,1138,1492,-354,https://www.imdb.com/title/tt0404203/
1198,Perfume: The Story of a Murderer,1157,1153,4,https://www.imdb.com/title/tt0396171/
1199,House of Flying Daggers,1230,774,456,https://www.imdb.com/title/tt0385004/
1200,Green Street Hooligans,1248,1115,133,https://www.imdb.com/title/tt0385002/
1201,Sideways,1112,1941,-829,https://www.imdb.com/title/tt0375063/
1202,Harry Potter and the Order of the Phoenix,1395,464,931,https://www.imdb.com/title/tt0373889/
1203,Kiss Kiss Bang Bang,1044,1324,-280,https://www.imdb.com/title/tt0373469/
1204,Collateral,996,1835,-839,https://www.imdb.com/title/tt0369339/
1209,The Aviator,1118,1494,-376,https://www.imdb.com/title/tt0338751/
1213,The Hours,1314,864,450,https://www.imdb.com/title/tt0274558/
1214,Ice Age,1096,770,326,https://www.imdb.com/title/tt0268380/
1217,The Man Who Wasn't There,1007,1363,-356,https://www.imdb.com/title/tt0243133/
1219,Gangs of New York,985,1616,-631,https://www.imdb.com/title/tt0217505/
1226,High Fidelity,1193,1527,-334,https://www.imdb.com/title/tt0146882/
1228,Star Wars: Episode III - Revenge of the Sith,1103,1398,-295,https://www.imdb.com/title/tt0121766/
1229,Pleasantville,1261,991,270,https://www.imdb.com/title/tt0120789/
1233,Jackie Brown,1135,1271,-136,https://www.imdb.com/title/tt0119396/
1234,The Devil's Advocate,1175,1077,98,https://www.imdb.com/title/tt0118971/
1237,A Time to Kill,1322,816,506,https://www.imdb.com/title/tt0117913/
1238,Leaving Las Vegas,1111,1632,-521,https://www.imdb.com/title/tt0113627/
1242,Interview with the Vampire: The Vampire Chronicles,1142,773,369,https://www.imdb.com/title/tt0110148/
1247,Army of Darkness,1210,1471,-261,https://www.imdb.com/title/tt0106308/
1253,Thelma & Louise,1349,675,674,https://www.imdb.com/title/tt0103074/
1255,Total Recall,1023,1776,-753,https://www.imdb.com/title/tt0100802/
1258,Field of Dreams,1165,1542,-377,https://www.imdb.com/title/tt0097351/
1259,Batman,1102,1345,-243,https://www.imdb.com/title/tt0096895/
1260,The Abyss,982,1281,-299,https://www.imdb.com/title/tt0096754/
1263,A Fish Called Wanda,1108,1298,-190,https://www.imdb.com/title/tt0095159/
1264,Beetlejuice,1243,905,338,https://www.imdb.com/title/tt0094721/
1268,A Nightmare on Elm Street,1185,1435,-250,https://www.imdb.com/title/tt0087800/
1270,Trading Places,1197,1507,-310,https://www.imdb.com/title/tt0086465/
1271,The Meaning of Life,1136,1014,122,https://www.imdb.com/title/tt0085959/
1272,The Evil Dead,1140,1729,-589,https://www.imdb.com/title/tt0083907/
1276,National Lampoon's Animal House,1073,1742,-669,https://www.imdb.com/title/tt0077975/
1277,The Omen,1052,1337,-285,https://www.imdb.com/title/tt0075005/
1280,The Texas Chain Saw Massacre,1183,1846,-663,https://www.imdb.com/title/tt0072271/
1296,Onward,1476,994,482,https://www.imdb.com/title/tt7146812/
1300,John Wick: Chapter 3 - Parabellum,1403,1501,-98,https://www.imdb.com/title/tt6146586/
1301,Uncut Gems,1215,1993,-778,https://www.imdb.com/title/tt5727208/
1304,Moonlight,1462,1093,369,https://www.imdb.com/title/tt4975722/
1305,Lady Bird,1345,1589,-244,https://www.imdb.com/title/tt4925292/
1308,Darkest Hour,1377,1372,5,https://www.imdb.com/title/tt4555426/
1309,Molly's Game,1283,1137,146,https://www.imdb.com/title/tt4209788/
1311,The Nice Guys,1396,1792,-396,https://www.imdb.com/title/tt3799694/
1314,The Disaster Artist,1428,1702,-274,https://www.imdb.com/title/tt3521126/
1315,War for the Planet of the Apes,1331,1323,8,https://www.imdb.com/title/tt3450958/
1316,Sully,1277,1139,138,https://www.imdb.com/title/tt3263904/
1317,The Jungle Book,924,1069,-145,https://www.imdb.com/title/tt3040964/
1318,John Wick,1502,1664,-162,https://www.imdb.com/title/tt2911666/
1319,I Origins,1588,889,699,https://www.imdb.com/title/tt2884206/
1321,Me Before You,1851,1039,812,https://www.imdb.com/title/tt2674426/
1325,Mission: Impossible - Rogue Nation,1371,1543,-172,https://www.imdb.com/title/tt2381249/
1326,The Hobbit: The Battle of the Five Armies,1437,884,553,https://www.imdb.com/title/tt2310332/
1327,Frozen,1439,614,825,https://www.imdb.com/title/tt2294629/
1328,Spider-Man: Homecoming,1366,1182,184,https://www.imdb.com/title/tt2250912/
1331,Begin Again,1346,1399,-53,https://www.imdb.com/title/tt1980929/
1333,Mud,1275,1782,-507,https://www.imdb.com/title/tt1935179/
1335,The Judge,1353,1047,306,https://www.imdb.com/title/tt1872194/
1337,Southpaw,1456,1129,327,https://www.imdb.com/title/tt1798684/
1339,Zero Dark Thirty,1290,1578,-288,https://www.imdb.com/title/tt1790885/
1341,The Way Way Back,1406,1382,24,https://www.imdb.com/title/tt1727388/
1342,Ready Player One,1306,1381,-75,https://www.imdb.com/title/tt1677720/
1345,"Crazy, Stupid, Love.",1438,1202,236,https://www.imdb.com/title/tt1570728/
1348,Cloud Atlas,1295,1155,140,https://www.imdb.com/title/tt1371111/
1351,Looper,1287,1564,-277,https://www.imdb.com/title/tt1276104/
1352,Mission: Impossible - Ghost Protocol,1383,1630,-247,https://www.imdb.com/title/tt1229238/
1354,Limitless,1370,1524,-154,https://www.imdb.com/title/tt1219289/
1355,Law Abiding Citizen,1416,1146,270,https://www.imdb.com/title/tt1197624/
1356,Up in the Air,1166,1885,-719,https://www.imdb.com/title/tt1193138/
1359,Pirate Radio,1410,820,590,https://www.imdb.com/title/tt1131729/
1360,Blue Valentine,1332,1707,-375,https://www.imdb.com/title/tt1120985/
1364,REC,1196,1832,-636,https://www.imdb.com/title/tt1038988/
1367,The Bucket List,1338,1170,168,https://www.imdb.com/title/tt0825232/
1368,Death at a Funeral,1520,1130,390,https://www.imdb.com/title/tt0795368/
1372,Juno,1337,1185,152,https://www.imdb.com/title/tt0467406/
1374,The Orphanage,1325,1109,216,https://www.imdb.com/title/tt0464141/
1375,Wonder Woman,1567,798,769,https://www.imdb.com/title/tt0451279/
1376,Babel,1268,1267,1,https://www.imdb.com/title/tt0449467/
1384,A History of Violence,1263,1831,-568,https://www.imdb.com/title/tt0399146/
1385,Memoirs of a Geisha,1895,869,1026,https://www.imdb.com/title/tt0397535/
1388,The Constant Gardener,1380,1085,295,https://www.imdb.com/title/tt0387131/
1389,The Terminal,1448,1642,-194,https://www.imdb.com/title/tt0362227/
1390,Garden State,1266,1506,-240,https://www.imdb.com/title/tt0333766/
1392,Wallace & Gromit: The Curse of the Were-Rabbit,1297,1565,-268,https://www.imdb.com/title/tt0312004/
1393,Master and Commander: The Far Side of the World,1344,1708,-364,https://www.imdb.com/title/tt0311113/
1395,Harry Potter and the Chamber of Secrets,1633,559,1074,https://www.imdb.com/title/tt0295297/
1396,Irreversible,1401,1620,-219,https://www.imdb.com/title/tt0290673/
1397,X2: X-Men United,1328,1375,-47,https://www.imdb.com/title/tt0290334/
1398,A Walk to Remember,1694,1341,353,https://www.imdb.com/title/tt0281358/
1400,K-PAX,1373,1439,-66,https://www.imdb.com/title/tt0272152/
1405,Equilibrium,1302,1126,176,https://www.imdb.com/title/tt0238380/
1407,Erin Brockovich,1595,1187,408,https://www.imdb.com/title/tt0195685/
1408,Pi,1402,1518,-116,https://www.imdb.com/title/tt0138704/
1409,The Talented Mr. Ripley,1451,1179,272,https://www.imdb.com/title/tt0134119/
1411,Man on the Moon,1225,1687,-462,https://www.imdb.com/title/tt0125664/
1413,The Emperor's New Groove,1730,1008,722,https://www.imdb.com/title/tt0120917/
1414,X-Men,1481,1031,450,https://www.imdb.com/title/tt0120903/
1416,Eyes Wide Shut,1218,1975,-757,https://www.imdb.com/title/tt0120663/
1419,Contact,1286,1607,-321,https://www.imdb.com/title/tt0118884/
1422,The Rock,1260,1605,-345,https://www.imdb.com/title/tt0117500/
1425,The English Patient,1460,1018,442,https://www.imdb.com/title/tt0116209/
1432,Dracula,1222,1040,182,https://www.imdb.com/title/tt0103874/
1433,Back to the Future Part III,1232,1484,-252,https://www.imdb.com/title/tt0099088/
1436,Wall Street,1359,1924,-565,https://www.imdb.com/title/tt0094291/
1438,Labyrinth,1692,574,1118,https://www.imdb.com/title/tt0091369/
1440,The NeverEnding Story,1527,894,633,https://www.imdb.com/title/tt0088323/
1457,Eraserhead,1433,1697,-264,https://www.imdb.com/title/tt0074486/
1458,Carrie,1390,1412,-22,https://www.imdb.com/title/tt0074285/
1461,The Rocky Horror Picture Show,1791,514,1277,https://www.imdb.com/title/tt0073629/
1473,From Russia with Love,1280,1868,-588,https://www.imdb.com/title/tt0057076/
1477,Alice in Wonderland,1555,1072,483,https://www.imdb.com/title/tt0043274/
1479,Pinocchio,1100,1741,-641,https://www.imdb.com/title/tt0032910/
1480,El Camino: A Breaking Bad Movie,1533,1849,-316,https://www.imdb.com/title/tt9243946/
1483,Hereditary,1508,1965,-457,https://www.imdb.com/title/tt7784604/
1485,The Ballad of Buster Scruggs,1600,1787,-187,https://www.imdb.com/title/tt6412452/
1487,Doctor Sleep,1492,1628,-136,https://www.imdb.com/title/tt5606664/
1488,The Shape of Water,1553,1534,19,https://www.imdb.com/title/tt5580390/
1491,Split,1491,1391,100,https://www.imdb.com/title/tt4972582/
1495,13 Hours,1639,1248,391,https://www.imdb.com/title/tt4172430/
1496,The Lego Batman Movie,1607,1508,99,https://www.imdb.com/title/tt4116284/
1497,Okja,1658,1117,541,https://www.imdb.com/title/tt3967856/
1498,Snowden,1676,1519,157,https://www.imdb.com/title/tt3774114/
1500,The Walk,1601,1675,-74,https://www.imdb.com/title/tt3488710/
1505,Fantastic Beasts and Where to Find Them,1804,887,917,https://www.imdb.com/title/tt3183660/
1506,The Conjuring 2,1590,1637,-47,https://www.imdb.com/title/tt3065204/
1508,Chef,1615,1673,-58,https://www.imdb.com/title/tt2883512/
1515,Avengers: Age of Ultron,1665,1071,594,https://www.imdb.com/title/tt2395427/
1516,Blue Jasmine,1638,1579,59,https://www.imdb.com/title/tt2334873/
1517,Finding Dory,1684,1080,604,https://www.imdb.com/title/tt2277860/
1519,American Sniper,1628,1612,16,https://www.imdb.com/title/tt2179136/
1520,The Accountant,1475,1502,-27,https://www.imdb.com/title/tt2140479/
1523,Rocketman,1748,1070,678,https://www.imdb.com/title/tt2066051/
1525,Flight,1452,1847,-395,https://www.imdb.com/title/tt1907668/
1526,The Edge of Seventeen,1486,1645,-159,https://www.imdb.com/title/tt1878870/
1527,Black Panther,1844,789,1055,https://www.imdb.com/title/tt1825683/
1528,The Place Beyond the Pines,1412,1763,-351,https://www.imdb.com/title/tt1817273/
1530,Despicable Me 2,1637,1044,593,https://www.imdb.com/title/tt1690953/
1531,Now You See Me,1777,1101,676,https://www.imdb.com/title/tt1670345/
1532,The Man from U.N.C.L.E.,1681,1164,517,https://www.imdb.com/title/tt1638355/
1533,Fast Five,1580,1180,400,https://www.imdb.com/title/tt1596343/
1535,The Next Three Days,1343,1595,-252,https://www.imdb.com/title/tt1458175/
1536,Monsters University,1713,1303,410,https://www.imdb.com/title/tt1453405/
1537,Rise of the Guardians,1917,623,1294,https://www.imdb.com/title/tt1446192/
1542,It,1484,1592,-108,https://www.imdb.com/title/tt1396484/
1551,First Man,1584,1903,-319,https://www.imdb.com/title/tt1213641/
1552,Lawless,1661,1444,217,https://www.imdb.com/title/tt1212450/
1554,The Lincoln Lawyer,1466,1431,35,https://www.imdb.com/title/tt1189340/
1555,An Education,1710,1406,304,https://www.imdb.com/title/tt1174732/
1557,Invictus,1505,1397,108,https://www.imdb.com/title/tt1057500/
1558,The Descendants,1429,1833,-404,https://www.imdb.com/title/tt1033575/
1559,RocknRolla,1507,1427,80,https://www.imdb.com/title/tt1032755/
1561,The Way Back,1516,1378,138,https://www.imdb.com/title/tt1023114/
1562,The Adventures of Tintin: The Secret of the Unicorn,1440,1750,-310,https://www.imdb.com/title/tt0983193/
1564,Revolutionary Road,1556,1539,17,https://www.imdb.com/title/tt0959337/
1565,Precious,1700,1218,482,https://www.imdb.com/title/tt0929632/
1567,Lars and the Real Girl,1512,1297,215,https://www.imdb.com/title/tt0805564/
1569,Mr. Brooks,1397,1791,-394,https://www.imdb.com/title/tt0780571/
1570,Ant-Man,1627,1545,82,https://www.imdb.com/title/tt0478970/
1572,The Simpsons Movie,1510,1871,-361,https://www.imdb.com/title/tt0462538/
1573,Rescue Dawn,1560,1650,-90,https://www.imdb.com/title/tt0462504/
1574,Across the Universe,1738,997,741,https://www.imdb.com/title/tt0445922/
1575,Borat: Cultural Learnings of America for Make Benefit Glorious Nation of Kazakhstan,1495,1998,-503,https://www.imdb.com/title/tt0443453/
1576,Lincoln,1414,1639,-225,https://www.imdb.com/title/tt0443272/
1578,Alita: Battle Angel,1541,1754,-213,https://www.imdb.com/title/tt0437086/
1579,The Queen,1602,1572,30,https://www.imdb.com/title/tt0436697/
1580,Clerks II,1422,1922,-500,https://www.imdb.com/title/tt0424345/
1584,Sweeney Todd: The Demon Barber of Fleet Street,1712,1095,617,https://www.imdb.com/title/tt0408236/
1587,Coach Carter,1583,1498,85,https://www.imdb.com/title/tt0393162/
1588,Brick,1653,1902,-249,https://www.imdb.com/title/tt0393109/
1590,Pirates of the Caribbean: Dead Man's Chest,1589,1183,406,https://www.imdb.com/title/tt0383574/
1591,Capote,1449,1352,97,https://www.imdb.com/title/tt0379725/
1592,Layer Cake,1523,1937,-414,https://www.imdb.com/title/tt0375912/
1594,Dawn of the Dead,495,1226,-731,https://www.imdb.com/title/tt0363547/
1595,The Life Aquatic with Steve Zissou,1526,1713,-187,https://www.imdb.com/title/tt0362270/
1596,The Secret Life of Walter Mitty,1455,1425,30,https://www.imdb.com/title/tt0359950/
1598,Monster,1660,1407,253,https://www.imdb.com/title/tt0340855/
1599,Troy,1670,1863,-193,https://www.imdb.com/title/tt0332452/
1601,Matchstick Men,1596,1826,-230,https://www.imdb.com/title/tt0325805/
1602,Spider-Man 2,1529,1981,-452,https://www.imdb.com/title/tt0316654/
1603,Identity,1554,1450,104,https://www.imdb.com/title/tt0309698/
1610,Punch-Drunk Love,1550,1997,-447,https://www.imdb.com/title/tt0272338/
1611,Unbreakable,1511,1936,-425,https://www.imdb.com/title/tt0217869/
1613,Frequency,1501,1162,339,https://www.imdb.com/title/tt0186151/
1616,Galaxy Quest,1515,1161,354,https://www.imdb.com/title/tt0177789/
1617,"Girl, Interrupted",1898,806,1092,https://www.imdb.com/title/tt0172493/
1620,Sleepy Hollow,1517,1274,243,https://www.imdb.com/title/tt0162661/
1621,Ghost World,1521,1647,-126,https://www.imdb.com/title/tt0162346/
1622,10 Things I Hate About You,1985,856,1129,https://www.imdb.com/title/tt0147800/
1624,Spider-Man,1535,1906,-371,https://www.imdb.com/title/tt0145487/
1625,Rounders,1379,1973,-594,https://www.imdb.com/title/tt0128442/
1626,Ronin,1558,1964,-406,https://www.imdb.com/title/tt0122690/
1627,Corpse Bride,1691,941,750,https://www.imdb.com/title/tt0121164/
1628,Tarzan,1800,1433,367,https://www.imdb.com/title/tt0120855/
1629,The Negotiator,1569,1618,-49,https://www.imdb.com/title/tt0120768/
1631,Enemy of the State,1519,1721,-202,https://www.imdb.com/title/tt0120660/
1632,Dogma,1617,1275,342,https://www.imdb.com/title/tt0120655/
1633,Men in Black,1463,1666,-203,https://www.imdb.com/title/tt0119654/
1634,Hercules,1856,1159,697,https://www.imdb.com/title/tt0119282/
1637,Scream,1695,1725,-30,https://www.imdb.com/title/tt0117571/
1639,Jerry Maguire,1543,1874,-331,https://www.imdb.com/title/tt0116695/
1643,Friday,1551,1587,-36,https://www.imdb.com/title/tt0113118/
1644,Crimson Tide,1493,1786,-293,https://www.imdb.com/title/tt0112740/
1645,The Basketball Diaries,1524,1316,208,https://www.imdb.com/title/tt0112461/
1647,Natural Born Killers,1598,1206,392,https://www.imdb.com/title/tt0110632/
1651,Dumb and Dumber,1335,1999,-664,https://www.imdb.com/title/tt0109686/
1659,Point Break,1566,1719,-153,https://www.imdb.com/title/tt0102685/
1660,Cape Fear,713,700,13,https://www.imdb.com/title/tt0101540/
1665,Driving Miss Daisy,1444,1217,227,https://www.imdb.com/title/tt0097239/
1666,Willow,1682,1136,546,https://www.imdb.com/title/tt0096446/
1668,They Live,1568,1793,-225,https://www.imdb.com/title/tt0096256/
1670,Big,1480,1553,-73,https://www.imdb.com/title/tt0094737/
1671,Raising Arizona,1393,1726,-333,https://www.imdb.com/title/tt0093822/
1672,The Lost Boys,1835,1112,723,https://www.imdb.com/title/tt0093437/
1673,"Good Morning, Vietnam",1443,1386,57,https://www.imdb.com/title/tt0093105/
1678,Big Trouble in Little China,1546,1888,-342,https://www.imdb.com/title/tt0090728/
1683,The Karate Kid,1651,1739,-88,https://www.imdb.com/title/tt0087538/
1684,Gremlins,1572,1800,-228,https://www.imdb.com/title/tt0087363/
1685,Beverly Hills Cop,1461,1865,-404,https://www.imdb.com/title/tt0086960/
1686,Poltergeist,1399,1570,-171,https://www.imdb.com/title/tt0084516/
1689,Caddyshack,1539,1948,-409,https://www.imdb.com/title/tt0080487/
1690,Rocky II,1685,1917,-232,https://www.imdb.com/title/tt0079817/
1691,Superman,1419,1611,-192,https://www.imdb.com/title/tt0078346/
1698,Easy Rider,1506,1768,-262,https://www.imdb.com/title/tt0064276/
1700,One Hundred and One Dalmatians,1864,1169,695,https://www.imdb.com/title/tt0055254/
1701,Lady and the Tramp,1847,954,893,https://www.imdb.com/title/tt0048280/
1702,Peter Pan,1709,1177,532,https://www.imdb.com/title/tt0046183/
1703,Cinderella,1957,934,1023,https://www.imdb.com/title/tt0042332/
1704,Bambi,1610,1394,216,https://www.imdb.com/title/tt0034492/
1708,The Post,1858,1814,44,https://www.imdb.com/title/tt6294822/
1709,Vice,1783,1728,55,https://www.imdb.com/title/tt6266538/
1715,The Founder,1680,1919,-239,https://www.imdb.com/title/tt4276820/
1721,American Made,1852,1932,-80,https://www.imdb.com/title/tt3532216/
1722,The Lobster,1910,1873,37,https://www.imdb.com/title/tt3464902/
1725,Coherence,1725,1705,20,https://www.imdb.com/title/tt2866360/
1726,T2 Trainspotting,1827,1655,172,https://www.imdb.com/title/tt2763304/
1733,Carol,1720,1758,-38,https://www.imdb.com/title/tt2402927/
1740,Steve Jobs,1765,1979,-214,https://www.imdb.com/title/tt2080374/
1741,Seven Psychopaths,1830,1704,126,https://www.imdb.com/title/tt1931533/
1745,Unbroken,1918,1149,769,https://www.imdb.com/title/tt1809398/
1746,American Hustle,1605,1921,-316,https://www.imdb.com/title/tt1800241/
1749,Shame,1656,1933,-277,https://www.imdb.com/title/tt1723811/
1750,Carnage,1781,1875,-94,https://www.imdb.com/title/tt1692486/
1751,The Age of Adaline,1848,1470,378,https://www.imdb.com/title/tt1655441/
1752,"Love, Rosie",1991,1541,450,https://www.imdb.com/title/tt1638002/
1755,War Horse,1812,1118,694,https://www.imdb.com/title/tt1568911/
1756,The Master,1808,1987,-179,https://www.imdb.com/title/tt1560747/
1758,Melancholia,1906,1808,98,https://www.imdb.com/title/tt1527186/
1761,The Hunger Games,1944,651,1293,https://www.imdb.com/title/tt1392170/
1762,The Great Gatsby,1809,1266,543,https://www.imdb.com/title/tt1343092/
1763,Lee Daniels' The Butler,1963,1295,668,https://www.imdb.com/title/tt1327773/
1765,Kung Fu Panda 2,1626,1790,-164,https://www.imdb.com/title/tt1302011/
1769,21 Jump Street,1775,1723,52,https://www.imdb.com/title/tt1232829/
1771,Rango,1642,1972,-330,https://www.imdb.com/title/tt1192628/
1775,10 Cloverfield Lane,1645,1929,-284,https://www.imdb.com/title/tt1179933/
1777,The Ghost Writer,1718,1879,-161,https://www.imdb.com/title/tt1139328/
1778,Paddington,1798,1512,286,https://www.imdb.com/title/tt1109624/
1780,Defiance,1871,1544,327,https://www.imdb.com/title/tt1034303/
1782,Megamind,1703,1526,177,https://www.imdb.com/title/tt1001526/
1784,The Road,1687,1872,-185,https://www.imdb.com/title/tt0898367/
1786,The Darjeeling Limited,1790,1446,344,https://www.imdb.com/title/tt0838221/
1787,Shooter,1863,1824,39,https://www.imdb.com/title/tt0822854/
1789,Silence,1839,1967,-128,https://www.imdb.com/title/tt0490215/
1790,Fracture,1740,1430,310,https://www.imdb.com/title/tt0488120/
1791,The Croods,1883,1400,483,https://www.imdb.com/title/tt0481499/
1793,I Am Legend,1850,1844,6,https://www.imdb.com/title/tt0480249/
1797,Michael Clayton,1693,1900,-207,https://www.imdb.com/title/tt0465538/
1800,The Equalizer,1707,1715,-8,https://www.imdb.com/title/tt0455944/
1801,Sunshine,1618,1828,-210,https://www.imdb.com/title/tt0448134/
1803,The Descent,1780,1892,-112,https://www.imdb.com/title/tt0435625/
1806,The Fountain,1726,1734,-8,https://www.imdb.com/title/tt0414993/
1814,Closer,1662,1730,-68,https://www.imdb.com/title/tt0376541/
1815,Team America: World Police,1805,1992,-187,https://www.imdb.com/title/tt0372588/
1820,King Kong,500,1292,-792,https://www.imdb.com/title/tt0360717/
1821,Anchorman: The Legend of Ron Burgundy,1677,1985,-308,https://www.imdb.com/title/tt0357413/
1823,The Passion of the Christ,1932,1624,308,https://www.imdb.com/title/tt0335345/
1825,Kingdom of Heaven,1650,1947,-297,https://www.imdb.com/title/tt0320661/
1827,The Dreamers,1897,1469,428,https://www.imdb.com/title/tt0309987/
1828,Chicago,1981,1332,649,https://www.imdb.com/title/tt0299658/
1829,Shrek 2,1807,1575,232,https://www.imdb.com/title/tt0298148/
1830,The Phantom of the Opera,1989,933,1056,https://www.imdb.com/title/tt0293508/
1831,Red Dragon,1731,1561,170,https://www.imdb.com/title/tt0289765/
1833,Insomnia,1724,1960,-236,https://www.imdb.com/title/tt0278504/
1834,We Were Soldiers,1826,1858,-32,https://www.imdb.com/title/tt0277434/
1835,Lilo & Stitch,1951,1234,717,https://www.imdb.com/title/tt0275847/
1837,Chocolat,1885,1158,727,https://www.imdb.com/title/tt0241303/
1839,The Matrix Reloaded,1762,1920,-158,https://www.imdb.com/title/tt0234215/
1840,Pay It Forward,1927,1197,730,https://www.imdb.com/title/tt0223897/
1842,A.I. Artificial Intelligence,1890,1688,202,https://www.imdb.com/title/tt0212720/
1843,Men of Honor,1756,1213,543,https://www.imdb.com/title/tt0203019/
1844,The Bank Job,1705,1925,-220,https://www.imdb.com/title/tt0200465/
1845,The Patriot,1870,1692,178,https://www.imdb.com/title/tt0187393/
1849,Cold Mountain,1882,1566,316,https://www.imdb.com/title/tt0159365/
1850,The Virgin Suicides,1828,1676,152,https://www.imdb.com/title/tt0159097/
1854,Treasure Planet,1969,1528,441,https://www.imdb.com/title/tt0133240/
1856,Cube,1667,1859,-192,https://www.imdb.com/title/tt0123755/
1859,A Bug's Life,1806,1807,-1,https://www.imdb.com/title/tt0120623/
1860,Starship Troopers,1564,1991,-427,https://www.imdb.com/title/tt0120201/
1862,Meet Joe Black,1842,1699,143,https://www.imdb.com/title/tt0119643/
1865,Face/Off,1613,1820,-207,https://www.imdb.com/title/tt0119094/
1866,Chasing Amy,1606,1984,-378,https://www.imdb.com/title/tt0118842/
1867,Anastasia,2000,810,1190,https://www.imdb.com/title/tt0118617/
1869,Mission: Impossible,1814,1968,-154,https://www.imdb.com/title/tt0117060/
1871,From Dusk Till Dawn,1614,1821,-207,https://www.imdb.com/title/tt0116367/
1874,GoldenEye,1787,1983,-196,https://www.imdb.com/title/tt0113189/
1875,Desperado,1820,1864,-44,https://www.imdb.com/title/tt0112851/
1876,True Lies,1686,1809,-123,https://www.imdb.com/title/tt0111503/
1877,Speed,1704,1694,10,https://www.imdb.com/title/tt0111257/
1891,Die Hard 2,1815,1935,-120,https://www.imdb.com/title/tt0099423/
1894,Lethal Weapon 2,1683,1848,-165,https://www.imdb.com/title/tt0097733/
1916,Escape from New York,1838,1949,-111,https://www.imdb.com/title/tt0082340/
1921,Grease,1975,1012,963,https://www.imdb.com/title/tt0077631/
1925,Mean Streets,1646,1853,-207,https://www.imdb.com/title/tt0070379/
1935,Dr. No,1640,1899,-259,https://www.imdb.com/title/tt0055928/
1936,Sleeping Beauty,1904,1121,783,https://www.imdb.com/title/tt0053285/
1940,Dumbo,1759,1597,162,https://www.imdb.com/title/tt0033563/
1943,Midsommar,1953,1954,-1,https://www.imdb.com/title/tt8772262/
1946,The Devil All the Time,1967,1898,69,https://www.imdb.com/title/tt7395114/
1949,Bad Times at the El Royale,1930,1883,47,https://www.imdb.com/title/tt6628394/
1952,Creed II,1948,1733,215,https://www.imdb.com/title/tt6343314/
1955,Sicario: Day of the Soldado,1960,1955,5,https://www.imdb.com/title/tt5052474/
1960,Don't Breathe,1912,1956,-44,https://www.imdb.com/title/tt4160708/
1967,Allied,1880,1915,-35,https://www.imdb.com/title/tt3640424/
1970,Sing,1947,1619,328,https://www.imdb.com/title/tt3470600/
1976,Furious 7,1961,1108,853,https://www.imdb.com/title/tt2820852/
1978,Beauty and the Beast,635,40,595,https://www.imdb.com/title/tt2771200/
1981,Everest,1970,1825,145,https://www.imdb.com/title/tt2719848/
1982,Locke,1902,1913,-11,https://www.imdb.com/title/tt2692904/
1983,Star Trek Beyond,1984,1535,449,https://www.imdb.com/title/tt2660888/
1986,The Intern,1923,1613,310,https://www.imdb.com/title/tt2361509/
1988,Wild,1937,1548,389,https://www.imdb.com/title/tt2305051/
1990,Kung Fu Panda 3,1939,1680,259,https://www.imdb.com/title/tt2267968/
1997,Side Effects,1919,1940,-21,https://www.imdb.com/title/tt2053463/
1998,War Dogs,1894,1938,-44,https://www.imdb.com/title/tt2005151/
2000,Pitch Perfect,1983,1383,600,https://www.imdb.com/title/tt1981677/
